‰∏ÄÊúà	Jan.|January
‰∫åÊúà	Feb.|February
‰∏âÊúà	Mar.|March
ÂõõÊúà	Apr.|April
‰∫îÊúà	May
ÂÖ≠Êúà	June
‰∏ÉÊúà	July
ÂÖ´Êúà	Aug.|August
‰πùÊúà	Sep.|Sept.|September
ÂçÅÊúà	Oct.|October
ÂçÅ‰∏ÄÊúà	Nov.|November
ÂçÅ‰∫åÊúà	Dec.|December
‰∏ÄÊúà‰ªΩ	Jan.|January
‰∫åÊúà‰ªΩ	Feb.|February
‰∏âÊúà‰ªΩ	Mar.|March
ÂõõÊúà‰ªΩ	Apr.|April
‰∫îÊúà‰ªΩ	May
ÂÖ≠Êúà‰ªΩ	June
‰∏ÉÊúà‰ªΩ	July
ÂÖ´Êúà‰ªΩ	Aug.|August
‰πùÊúà‰ªΩ	Sep.|Sept.|September
ÂçÅÊúà‰ªΩ	Oct.|October
ÂçÅ‰∏ÄÊúà‰ªΩ	Nov.|November
ÂçÅ‰∫åÊúà‰ªΩ	Dec.|December
Âë®‰∏Ä	Mon.|Monday
Âë®‰∫å	Tue.|Tuesday
Âë®‰∏â	Wed.|Wednesday
Âë®Âõõ	Thu.|Thurs.|Thursday
Âë®‰∫î	Fri.|Friday
Âë®ÂÖ≠	Sat.|Saturday
Âë®Êó•	Sun.|Sunday
Á§ºÊãú‰∏Ä	Mon.|Monday
Á§ºÊãú‰∫å	Tue.|Tuesday
Á§ºÊãú‰∏â	Wed.|Wednesday
Á§ºÊãúÂõõ	Thu.|Thurs.|Thursday
Á§ºÊãú‰∫î	Fri.|Friday
Á§ºÊãúÂÖ≠	Sat.|Saturday
Á§ºÊãúÊó•	Sun.|Sunday
ÊòüÊúü‰∏Ä	Mon.|Monday
ÊòüÊúü‰∫å	Tue.|Tuesday
ÊòüÊúü‰∏â	Wed.|Wednesday
ÊòüÊúüÂõõ	Thu.|Thurs.|Thursday
ÊòüÊúü‰∫î	Fri.|Friday
ÊòüÊúüÂÖ≠	Sat.|Saturday
ÊòüÊúüÊó•	Sun.|Sunday
ÂéÇÈÉ®	ÂéÇ|‚∫Å
ÂÅèÂéÇ	ÂéÇ
ÂÅèÂéÇÂÑø	ÂéÇ
ÂéÇÂ≠óÂ§¥	ÂéÇ
ÂèçÂ≠óÊ°Ü	‚∫Å
ÂåöÈÉ®	ÂåöÈÉ®
Âå∫Â≠óÊ°Ü	Âåö
‰∏âÊ°Ü	Âåö
‰∏âÊ°ÜÂÑø	Âåö
ÂàÄÈÉ®	ÂàÇ
Á´ãÂàÄÊóÅ	ÂàÇ
Á´ãÂàÄ	ÂàÇ
ÂÜÇÈÉ®	ÂÜÇ|‚∫Ü
ÂêåÂ≠óÊ°Ü	ÂÜÇ|‚∫Ü
Âçï‰∫∫ÊóÅ	‰∫ª
‰∫∫Â≠óÊóÅ	‰∫ª
ÂçïÁ´ã‰∫∫	‰∫ª
ÊñúÂàÄÂ§¥	‚∫à
Ë¥üÂ≠óÂ§¥	‚∫à
ÂåÖÂ≠óÂ§¥	Âãπ
È£éÂ≠óÂ§¥	†ò®
Âá§Â≠óÊ°Ü	†ò®
Âá†Â≠óÂ§¥	†ò®
Âá†Â≠óÂ∫ï	†ò®
‰∫†ÈÉ®	‰∫†
‰∫¨Â≠óÂ§¥	‰∫†
ÂÜ´ÈÉ®	ÂÜ´
‰∏§ÁÇπÊ∞¥	ÂÜ´
ÂÜ∞Â≠óÊóÅ	ÂÜ´
ÂÖ´ÈÉ®	‰∏∑
ÂÄíÂÖ´	‰∏∑
ÂÖ∞Â≠óÂ§¥	‰∏∑
ÂÖ´Â≠óÂ§¥	‰∏∑
ÂÖ´Â≠óÂ∫ï	‰∏∑
ÂÄíÂÖ´Â≠ó	‰∏∑
ÂÜñÈÉ®	ÂÜñ
ÁßÉÂÆùÁõñ	ÂÜñ
Ë®ÄÈÉ®	ËÆ†|Ë®Å
Ë®ÄÂ≠óÊóÅ	ËÆ†|Ë®Å
Âá∂Â≠óÊ°Ü	Âáµ
ÂáµÈÉ®	Âáµ
Âç©ÈÉ®	Âç©
ËÄ≥ÂàÄÊóÅ	Âç©|Èòù
ÂçïËÄ≥ÊóÅ	Âç©
ÂçïËÄ≥ÂàÄ	Âç©
ÂçïËÄ≥Êúµ	Âç©
ÈÇëÈÉ®	Èòù
ÈòúÈÉ®	Èòù
ÂèåËÄ≥ÊóÅ	Èòù
ÂèåËÄ≥ÂàÄ	Èòù
Â∑¶ËÄ≥ÂàÄ	Èòù
Âè≥ËÄ≥ÂàÄ	Èòù
Âé∂ÈÉ®	Âé∂
ÁßÅÂ≠óÊóÅ	Âé∂
Âª¥ÈÉ®	Âª¥
Âª∫‰πãÊóÅ	Âª¥
„îæÈÉ®	„îæ
‰ªìÂ≠óÂ∫ï	„îæ
ÂúüÈÉ®	Âúü
ÊèêÂúüÊóÅ	Âúü
ÂúüÂ≠óÂ∫ï	Âúü
ÂúüÂ≠óÊóÅ	Âúü
ÊâãÈÉ®	Êâå
ÊèêÊâãÊóÅ	Êâå
Ëâ∏ÈÉ®	Ëâπ
ËçâÂ§¥	Ëâπ
ËçâÂ≠óÂ§¥	Ëâπ
ÂªæÈÉ®	Âªæ
ÂºÑÂ≠óÂ∫ï	Âªæ
Â∞¢ÈÉ®	Â∞¢
Â∞§Â≠óÊóÅ	Â∞¢
ÂõΩÂ≠óÊ°Ü	Âõó
Â§ßÂè£Ê°Ü	Âõó
ÊñπÊ°Ü	Âõó
Âèå‰∫∫ÊóÅ	ÂΩ≥
ÂèåÁ´ã‰∫∫	ÂΩ≥
ÂΩ≥ÈÉ®	ÂΩ≥
ÂΩ°ÈÉ®	ÂΩ°
‰∏âÊíá	ÂΩ°
‰∏âÊíáÂÑø	ÂΩ°
Áä¨ÈÉ®	Áä≠
ÂèçÁä¨ÊóÅ	Áä≠
Â§ÇÈÉ®	Â§Ç
ÊäòÊñá	Â§Ç
ÊäòÊñáÂÑø	Â§Ç
ÊäòÊñáÊóÅ	Â§Ç
ÂÜ¨Â≠óÂ§¥	Â§Ç
È£üÈÉ®	È•£
È£üÂ≠óÊóÅ	È•£
ÁàøÈÉ®	‰∏¨|Áàø
Â∞ÜÂ≠óÊóÅ	‰∏¨|Áàø
ÂπøÈÉ®	Âπø
ÂπøÂ≠óÊóÅ	Âπø
Ê∞¥ÈÉ®	Ê∞µ
‰∏âÁÇπÊ∞¥	Ê∞µ
ÂøÉÈÉ®	ÂøÑ
Á´ñÂøÉ	ÂøÑ
Á´ñÂøÉÊóÅ	ÂøÑ
ÂÆÄÈÉ®	ÂÆÄ
ÂÆùÁõñ	ÂÆÄ
ÂÆùÁõñÂÑø	ÂÆÄ
ÂÆùÁõñÂ§¥	ÂÆÄ
ÂÆùÁõñÂÑøÂ§¥	ÂÆÄ
ËæµÈÉ®	Ëæ∂
Ëµ∞‰πã	Ëæ∂
Ëµ∞‰πãÊóÅ	Ëæ∂
ÂΩêÈÉ®	ÂΩê
Èõ™Â≠óÂ∫ï	ÂΩê
Ê®™Â±±	ÂΩê
Â≠êÈÉ®	Â≠ê|Â≠ë
Â≠êÂ≠óÊóÅ	Â≠ê|Â≠ë
Á≥∏ÈÉ®	Á∫ü|Á≥π|Á≥∏
Áªû‰∏ù	Á∫ü|Á≥π|Á≥∏
Áªû‰∏ùÂÑø	Á∫ü|Á≥π|Á≥∏
Áªû‰∏ùÊóÅ	Á∫ü|Á≥π|Á≥∏
Áªû‰∏ùÂÑøÊóÅ	Á∫ü|Á≥π|Á≥∏
‰π±Áªû‰∏ù	Á∫ü|Á≥π|Á≥∏
‰π±Áªû‰∏ùÂÑø	Á∫ü|Á≥π|Á≥∏
Áªû‰∏ùÂ∫ï	Á∫ü|Á≥π|Á≥∏
Âπ∫ÈÉ®	Âπ∫
ÂπºÂ≠óÊóÅ	Âπ∫
Â∑õÈÉ®	Â∑õ
‰∏âÊãê	Â∑õ
‰∏âÊãêÂÑø	Â∑õ
ÁéâÈÉ®	Áéã
ÁéãÂ≠óÊóÅ	Áéã
ÊñúÁéâÊóÅ	Áéã
ËÄÅÂ≠óÂ§¥	ËÄÇ
Êú®Â≠óÊóÅ	Êú®
ÁâõÂ≠óÊóÅ	Áâú|‚∫ß
ËΩ¶Â≠óÊóÅ	ËΩ¶
ÂèçÊñá	Êîµ
ÂèçÊñáÊóÅ	Êîµ
Áà™Â≠óÂ§¥	Áà´
ÁÅ´Â≠óÊóÅ	ÁÅ´
ÂõõÁÇπÂ∫ï	ÁÅ¨
ÂõõÁÇπÊ∞¥	ÁÅ¨
Á§∫Â≠óÊóÅ	Á§ª
Á§∫Ë°•	Á§ª
Á§∫Ë°•ÂÑø	Á§ª
Êò•Â≠óÂ§¥	Êò•
ÂõõÂ≠óÂ§¥	ÁΩí
ÊâÅÂõõÂ§¥	ÁΩí
ÁöøÂ≠óÂ∫ï	Áöø
ÁöøÂ¢©	Áöø
ÁöøÂ¢©ÂÑø	Áöø
ÈáëÂ≠óÊóÅ	ÈíÖ
Á¶æÊú®ÊóÅ	Á¶æ
ÁóÖÂ≠óÂ§¥	Áñí
ÁóÖÂ≠óÊóÅ	Áñí
ÁóÖÊóÅ	Áñí
Ë°£Â≠óÊóÅ	Ë°§
Ë°£Ë°•	Ë°§
Ë°£Ë°•ÂÑø	Ë°§
ÁôªÂ≠óÂ§¥	Áô∂
Ë•øÂ≠óÂ§¥	Ë¶Ä
ËôéÂ≠óÂ§¥	Ëôç
Á´πÂ≠óÂ§¥	‚∫Æ
ÁæäÂ≠óÊóÅ	‚∫∂|‚∫∑
ÁæäÂ≠óÂ§¥	‚∫∑|‚∫∂
Âç∑Â≠óÂ§¥	Èæπ
Á±≥Â≠óÊóÅ	Á±≥
Ë∂≥Â≠óÊóÅ	‚ªä
È´¶Â≠óÂ§¥	È´ü
Áü≥Â≠óÂ§¥	‰∏Ü
Áà±Áî∞È£ûÈ∏ü	„ÅÇ„ÅÑ„Å†È£õÈ≥•
Áà±‰πÉÂ®úÁæé	ÊÑõ‰πÉ„Å™„Åø
ÂÆâÊñãÊãâÊãâ	ÂÆâÈΩã„Çâ„Çâ|ÂÆáÈÉΩÂÆ´Á¥´Ëãë|ÂÆáÈÉΩÂÆÆ„Åó„Çí„Çì|RION
Ëãç‰∫ïÁ©∫	Ëíº‰∫ï„Åù„Çâ
ÈïøË∞∑Â∑ùÁêÜÁ©ó	Èï∑Ë∞∑Â∑ù„É™„Éõ
ÂΩ©ÁæéÊó¨Êûú	„ÅÇ„ÇÑ„ÅøÊó¨Êûú
Êò•Âí≤Âáâ	Êò•Âí≤„Çä„Çá„ÅÜ
ËíÇ‰∫ö	ËíÇ‰∫û|„ÉÜ„Ç£„Ç¢
Ê•™ÂèØÊÄú	Ê•™„Ç´„É¨„É≥
Â¶ÉÊÇ†Áà±	Â¶ÉÊÇ†ÊÑõ|ÈïøÊ≥ΩÊùèÂ•à|Èï∑Êæ§ÊùèÂ•à
ÈïøÊ≥ΩÊùèÂ•à	Èï∑Êæ§ÊùèÂ•à|Â¶ÉÊÇ†Áà±|Â¶ÉÊÇ†ÊÑõ
Êû´ÂèØÊÄú	Ê•ì„Ç´„É¨„É≥|Áî∞‰∏≠Êü†Ê™¨|Áî∞‰∏≠„É¨„É¢„É≥
Êû´Ëä±ÊÅã	Ê•ì„Ç´„É¨„É≥|Áî∞‰∏≠Êü†Ê™¨|Áî∞‰∏≠„É¨„É¢„É≥
ÂÆ´‰∏ãÂçéÂ•à	ÂÆÆ‰∏ãËèØÂ•à
Âè§Â∑ù‰ºäÁªá	Âè§Â∑ù„ÅÑ„Åä„Çä
ÂπøÊøëÈáåÁª™Ëèú	Â∫ÉÁÄ¨„Çä„Åä„Å™
Ê≤≥ÂåóÊò•Ëèú	Ê≤≥Âåó„ÅØ„Çã„Å™
ÂêâÂ∑ùËé≤	ÂêâÂ∑ùËìÆ
ÂêâÊ≥ΩÊòéÊ≠•	ÂêâÊ≤¢ÊòéÊ≠©
ÈìÉÊùëÁà±Èáå	Èà¥Êùë„ÅÇ„ÅÑ„Çä
ÂáâÊ£ÆÁé≤Ê¢¶	Ê∂ºÊ£Æ„Çå„ÇÄ
ÊûóÁî±Â•à	Êûó„ÇÜ„Å™
ÂáõÈü≥Ê°ÉËä±	ÂáõÈü≥„Å®„ÅÜ„Åã
ÈáåÁæéÂ∞§Âà©Â®Ö	ÈáåÁæé„ÇÜ„Çä„ÅÇ
Ëä¶ÂêçÂ∞§Ëéâ‰∫ö	Ëä¶Âêç„É¶„É™„Ç¢
ÁæéÈõ™ËâæËéâ‰∏ù	ÁæéÈõ™„ÅÇ„Çä„Åô
ÁõÆÈªëÊÉ†	ÁõÆÈªí„ÇÅ„Åê„Åø
ÊòéÈáå‰å∑	ÊòéÈáå„Å§„ÇÄ„Åé
‰∏ÉÊµ∑ËíÇÂ®ú	‰∏ÉÊµ∑„ÉÜ„Ç£„Éä
Â§©Êµ∑Áøº	Â§©Êµ∑„Å§„Å∞„Åï
Ê°ÉË∞∑ÁªòÈáåÈ¶ô	Ê°ÉË∞∑„Ç®„É™„Ç´
Ëæª‰∫ïÁ©ó‰πÉÊûú	Ëæª‰∫ï„Åª„ÅÆ„Åã
Ê°•Êú¨ÊúâËèú	Ê©ãÊú¨„ÅÇ„Çä„Å™|Êñ∞ÊúâËèú|Êñ∞„ÅÇ„Çä„Å™
Ê∑±Áî∞ÂíèÁæé	Ê∑±Áî∞„Åà„ÅÑ„Åø
‰∏â‰∏äÊÇ†‰∫ö	‰∏â‰∏äÊÇ†‰∫ú
Ê°É‰πÉÊú®È¶ôÂ•à	Ê°É‰πÉÊú®„Åã„Å™
Ê≠¶Ëó§Áª´È¶ô	Ê≠¶Ëó§„ÅÇ„ÇÑ„Åã
Â∏åÂ≤õÁà±ÁêÜ	Â∏åÂ≥∂„ÅÇ„ÅÑ„Çä
Â§èÂ∏åÊ†ó	Â§èÂ∏å„Åæ„Çç„Çì
Â∏åÂ¥éÊù∞Ë•øÂç°	Â∏åÂ¥é„Ç∏„Çß„Ç∑„Ç´
Â∞èÊ≥ΩÁéõÂà©‰∫ö	Â∞èÊæ§„Éû„É™„Ç¢
Â∞èÂ≤õÂçó	Â∞èÂ≥∂„Åø„Å™„Åø
Áõ∏Ê≥ΩÂçó	Áõ∏Ê≤¢„Åø„Å™„Åø
Êñ∞ÊúâËèú	Êñ∞„ÅÇ„Çä„Å™|Ê°•Êú¨ÊúâËèú|Ê©ãÊú¨„ÅÇ„Çä„Å™
ÊòüÂÆ´‰∏ÄËä±	ÊòüÂÆÆ‰∏ÄËä±
ÊòüÈáéÊôØÂ≠ê	„Åª„Åó„ÅÆÊôØÂ≠ê
ÊòüÈáéÂ®úÁæé	ÊòüÈáé„Éä„Éü
ÁØ†Áî∞Ê≠•Áæé	ÁØ†Áî∞„ÅÇ„ÇÜ„Åø
ÊüöÊú®ËíÇÂ®ú	ÊüöÊú®„ÉÜ„Ç£„Éä
ÊúâË¥∫Áî±Áà±	ÊúâË≥Ä„ÇÜ„ÅÇ
‰πôÁôΩÊ≤ô‰πüÂä†	‰πôÁôΩ„Åï„ÇÑ„Åã
Ê®±‰∫ïÊ≠•	Ê°ú‰∫ï„ÅÇ„ÇÜ
Ê®±‰∫ïÂΩ©	Ê°ú‰∫ïÂΩ©
Ê®±Á©∫Ê°É	Ê°úÁ©∫„ÇÇ„ÇÇ
ÂÆáÈÉΩÂÆ´Á¥´Ëãë	ÂÆáÈÉΩÂÆÆ„Åó„Çí„Çì|ÂÆâÊñãÊãâÊãâ|ÂÆâÈΩã„Çâ„Çâ|RION
‰∏Ä‰πãÊøë‰∫öÁæéËéâ	‰∏Ä„ÉéÁÄ¨„Ç¢„É°„É™
Ê®±Êú®Âáõ	Ê°úÊú®Âáõ
Âõ≠Áî∞ÁæéÊ®±	ÂúíÁî∞„Åø„Åä„Çì
Ê∞∏ÈáéÂè∏	Ê∞∏Èáé„Å§„Åã„Åï
Êó©Â∑ùÊøëÈáåÂ•à	Êó©Â∑ùÁÄ¨ÈáåÂ•à
Ê§éÂêçÁî±Â•à	Ê§éÂêç„ÇÜ„Å™
Á´πÂÜÖÊúâÁ∫™	Á´πÂÜÖÊúâÁ¥Ä
‰∏âÂÆ´Ê§ø	‰∏âÂÆÆ„Å§„Å∞„Åç
ËìùËäΩÊ∞¥Êúà	ËóçËäΩ„Åø„Åö„Åç
ÊòüÈáéÊòé	ÊòüÈáé„ÅÇ„Åã„Çä
Ëé≤ÂÆûÂÖãËïæÂÑø	ËìÆÂÆü„ÇØ„É¨„Ç¢
È¶ôËãóÁé≤Èü≥	È¶ôËãó„É¨„Éé„É≥
ÊúâÂéüÊ≠•Áæé	ÊúâÂéü„ÅÇ„ÇÜ„Åø
ÁæéË∞∑Êú±Èáå	ÁæéË∞∑„ÅÇ„Åã„Çä
Ê∞¥Â∑ùÂ†á	Ê∞¥Â∑ù„Çπ„Éü„É¨|Ê∞¥Á®ÄÁæéÈáå|Ê∞¥Á®Ä„Åø„Çä|ÁôæÂ§ö„Åà„Åø„Çä
Ê∞¥Á®ÄÁæéÈáå	Ê∞¥Á®Ä„Åø„Çä|Ê∞¥Â∑ùÂ†á|Ê∞¥Â∑ù„Çπ„Éü„É¨|ÁôæÂ§ö„Åà„Åø„Çä
Â∞èÂÆµËôéÂçó	Â∞èÂÆµ„Åì„Å™„Çì
Êñ∞ÊùëÊô∂	Êñ∞Êùë„ÅÇ„Åã„Çä
Ê£ÆÊ≥Ω‰Ω≥Â•à	Ê£ÆÊ≤¢„Åã„Å™|È•≠ÂÜà‰Ω≥Â•àÂ≠ê|È£ØÂ≤°„Åã„Å™„Åì
È•≠ÂÜà‰Ω≥Â•àÂ≠ê	È£ØÂ≤°„Åã„Å™„Åì|Ê£ÆÊ≥Ω‰Ω≥Â•à|Ê£ÆÊ≤¢„Åã„Å™
ÊúùÊó•Â•àËä±ÊÅã	ÊúùÊó•Â•à„Åã„Çå„Çì
È´òÊ°•Âú£Â≠ê	È´òÊ©ã„Åó„Çá„ÅÜÂ≠ê
Ë•øÂÆ´Ê¢¶	Ë•øÂÆÆ„ÇÜ„ÇÅ
Ëó§Ê£ÆÈáåÁ©ó	Ëó§Ê£ÆÈáåÁ©Ç
Êú®ÊùëÁ©ó‰πÉÈ¶ô	Êú®ÊùëÁ©Ç‰πÉÈ¶ô
Á•ûÂÆ´ÂØ∫Â•àÁª™	Á•ûÂÆÆÂØ∫„Éä„Ç™
Ê∞¥ÂçúÊ®±	Ê∞¥Âçú„Åï„Åè„Çâ
Áà±Èü≥È∫ªÈáå‰∫ö	ÊÑõÈü≥„Åæ„Çä„ÅÇ
ËâØÈü≥Ëç†	ËâØÈü≥„Å™„Åö„Å™
Êú¨Â∫ÑÈìÉ	Êú¨Â∫ÑÈà¥
ÊòéÊó•Ëä±ÁªÆÁΩó	ÊòéÊó•Ëä±„Ç≠„É©„É©
Â§ßÊ°•Êú™‰πÖ	Â§ßÊ©ãÊú™‰πÖ
ÊøëÂêçÂÖâËéâ	ÁÄ¨Âêç„Åç„Çâ„Çä
Ê†óÂ±±ËéâÁª™	Ê†óÂ±±ËéâÁ∑í
Á∫±Á∫±ÂéüÁôæÂêà	Á¥ó„ÄÖÂéü„ÇÜ„Çä
Â†ÄÂåóÊπæ	Â†ÄÂåó„Çè„Çì
ÂÜ≤Áî∞ÊùèÊ¢®	Ê≤ñÁî∞ÊùèÊ¢®
Â§©‰ΩøËêå	Â§©‰Ωø„ÇÇ„Åà
Ë•øÊù°ÁêâÁíÉ	Ë•øÊ¢ù„Çã„Çä
ÂêõÂ≤õÁæéÁª™	ÂêõÂ≥∂„Åø„Åä
Ê≥¢Â§öÈáéÁªìË°£	Ê≥¢Â§öÈáéÁµêË°£
Êùæ‰∏ãÁ∫±Ëç£Â≠ê	Êùæ‰∏ãÁ¥óÊ†ÑÂ≠ê
Â±±ÊâãÊ¢®Áà±	Â±±ÊâãÊ¢®ÊÑõ
Êøë‰∫öÁæéËéâ	ÁÄ¨„Ç¢„É°„É™
ÊúõÊúàÁêÜÊ≤ô	ÊúõÊúà„Çä„Åï
‰∏äÂéüÁëûÁ©ó	‰∏äÂéüÁëûÁ©Ç
Â≤¨Â•àÂ•àÁæé	Â≤¨„Å™„Å™„Åø
Á•ûËèúÁæéËàû	Á•ûËèúÁæé„Åæ„ÅÑ
ÁôΩÊ°ÉËä±	ÁôΩÊ°É„ÅØ„Å™
Ê†óÂÆ´ÂèåÂè∂	Ê†óÂÆÆ„Åµ„Åü„Å∞
È£ûÈ∏üÈáå‰ºäÂ•à	È£õÈ≥•„Çä„ÅÑ„Å™
Â§©Èü≥ÁúüÊØîÂ•à	Â§©Èü≥„Åæ„Å≤„Å™
Âá∞È¶ôÂ•àËäΩ	Âá∞„Åã„Å™„ÇÅ
ÁøºËàû	„Å§„Å∞„ÅïËàû
Á•ûÊú®‰∏Ω	Á•ûÊú®È∫ó
Â∞èËä±Êöñ	Â∞èËä±„ÅÆ„Çì
Â±±Âè£Âè∂Áêâ	Â±±Âè£ËëâÁë†
Ëµ§ÁõÆ‰∏ΩÂÖ∞	Ëµ§ÁõÆ„É¨„Ç§„É©„É≥
Â§©È©¨ÂîØ	Â§©È¶¨„ÇÜ„ÅÑ
‰∏ÉÊ£ÆËéâËéâ	‰∏É„ÉÑÊ£Æ„Çä„Çä
Áî∞‰∏≠Êü†Ê™¨	Áî∞‰∏≠„É¨„É¢„É≥|Êû´ÂèØÊÄú|Êû´Ëä±ÊÅã|Ê•ì„Ç´„É¨„É≥
Â∞èÂáëÂõõÂè∂	Â∞èÊπä„Çà„Å§Ëëâ
Áà±ÂÆùÈìÉ	ÊÑõÂÆù„Åô„Åö
Áà±ÂºìÂáâ	ÊÑõÂºì„Çä„Çá„ÅÜ
Áà±‰∏ñÊ¢¶Ëêù	ÊÑõ‰∏ñ„Åè„Çâ„Çâ
Áà±Áî∞Â•àÂ•à	ÊÑõÁî∞Â•à„ÄÖ
Áà±ÂéüÊ≤ôËÄ∂	Áà±Âéü„Åï„Åà
Áà±Ê≥ΩÊúâÁ∫±	ÊÑõÊ≤¢ÊúâÁ¥ó
ÂÆâËææÂ§ïËéâ	ÂÆâÈÅîÂ§ïËéâ
Â∫µÂß¨Ëä±	Â∫µ„Å≤„ÇÅ„Åã
ÂÆâÁæéÊ≥¢	ÂÆâ„Åø„Å™„Åø
ÂÆâ‰ΩçËñ∞	ÂÆâ‰Ωç„Ç´„É≤„É´
Â••‰∫ïÊû´	Â••‰∫ïÊ•ì
ÂÖ´ÊåÇÊµ∑	ÂÖ´Êéõ„ÅÜ„Åø
ÂÖ´Êú®Â•àÂ•à	ÂÖ´Êú®Â•à„ÄÖ
ÁôΩÂùÇÁæéÊùè	ÁôΩÂùÇ„Åø„ÅÇ„Çì
ÁôΩÂ∑ùÊüöÂ≠ê	ÁôΩÂ∑ù„ÇÜ„Åö
ÁôΩÂ≥∞ÁæéÁæΩ	ÁôΩÂ≥∞„Éü„Ç¶
ÁôæÊøëÈ£ûÈ∏ü	ÁôæÁÄ¨„ÅÇ„Åô„Åã
ÊüèÊú®Â∞èÂ§è	ÊüèÊú®„Åì„Å™„Å§
ÁôΩÊú®‰ºòÂ≠ê	ÁôΩÊú®ÂÑ™Â≠ê
ÁôΩÂ¥éÂΩ©Âè∂	ÁôΩÂ¥é„ÅÑ„Çç„ÅØ
ÁôæÊ∞∏Á∫±ÈáåÂ•à	ÁôæÊ∞∏„Åï„Çä„Å™
ÂùÇÈÅìÁæéÁêâ	ÂùÇÈÅì„Åø„Çã|miru
ÂùÇ‰∫ïÊàêÁæΩ	ÂùÇ‰∫ï„Å™„Çã„ÅØ
ÂÆùÁî∞ËêåÂ•àÁæé	ÂÆùÁî∞„ÇÇ„Å™„Åø
ÂåóÂ∑ùÁà±ËéâÈ¶ô	ÂåóÂ∑ù„Ç®„É™„Ç´
ÂåóÂ∑ùÊùèÊ†ë	ÂåóÂ∑ùÊùèÊ®π
ÂåóÂ∑ùÊüöÂ≠ê	ÂåóÂ∑ù„ÇÜ„Åö
Êú¨‰π°Áà±	Êú¨ÈÉ∑ÊÑõ|‰∫åÈò∂Â†ÇÊ¢¶|‰∫åÈöéÂ†ÇÂ§¢
Êú¨ÁúüÂèãÈáå	Êú¨Áúü„ÇÜ„Çä
Êú¨Â∫Ñ‰ºòËä±	Êú¨Â∫ÑÂÑ™Ëä±
Âπ∂Êú®‰ºò	‰∏¶Êú®ÂÑ™
‰ªìÊú¨Â†á	ÂÄâÊú¨„Åô„Åø„Çå
‰ªìÂ§öÁúüÂ§Æ	ÂÄâÂ§ö„Åæ„Åä
ÊúùÊØîÂ•à‰∏ÉÊøë	ÊúùÊØîÂ•à„Å™„Å™„Åõ
ÊúùÊó•ÈìÉ	ÊúùÊó•„Çä„Çì
ÊúùÊó•Â•àÂèØÊÄú	ÊúùÊó•Â•à„Åã„Çå„Çì
ÊúùÁî∞Êó•Ëëµ	ÊúùÁî∞„Å≤„Åæ„Çä
Ëæ∞Â∑≥ÂîØ	Ëæ∞Â∑≥„ÇÜ„ÅÑ
ÂàùÂ∑ùÂçó	ÂàùÂ∑ù„Åø„Å™„Åø
Â∑ùÂåóÈáåËèú	Â∑ùÂåó„Çä„Å™
Â∑ùÂåóÊòéÊ≤ô	Â∑ùÂåó„É°„Ç§„Çµ
Â∑ùÊùëÁúüÁü¢	Â∑ùÊùë„Åæ„ÇÑ
Â∑ùË∂äÂîØ	Â∑ùË∂ä„ÇÜ„ÅÑ
Ê§éÂêçÁ©∫	Ê§éÂêç„Åù„Çâ
ÂêπÁü≥Áé≤Â•à	ÂêπÁü≥„Çå„Å™
Êò•ËèúÂçé	Êò•Ëèú„ÅØ„Å™
Ê§øËéâÈ¶ô	Ê§ø„Çä„Åã
Â§ßÊßªÂìç	Â§ßÊßª„Å≤„Å≥„Åç
Á®ªÂú∫ÊµÅËä±	Á®≤Â†¥„Çã„Åã
Á®ªÂ∑ùÂ§èÁõÆ	Á®≤Â∑ù„Å™„Å§„ÇÅ|ÈªëÂ∑ùÂ†á|ÈªíÂ∑ù„Åô„Åø„Çå
Á®ªÊ£ÆÁæéÂøß	Á®≤Ê£ÆÁæéÊÜÇ
ÂÜ¨Áà±Áê¥Èü≥	ÂÜ¨ÊÑõ„Åì„Å®„Å≠
‰∏úÂáõ	Êù±Âáõ
‰∏úÊù°Â§è	Êù±Ê¢ù„Å™„Å§
ÂÜ¨ÊúàÊû´	ÂÜ¨Êúà„Åã„Åà„Åß
‰∏ú‰∫ëÁæéÁé≤	Êù±Èõ≤„Åø„Çå„ÅÑ
‰∫åÂÆ´ÂÖâ	‰∫åÂÆÆ„Å≤„Åã„Çä
‰∫åÈò∂Â†ÇÊ¢¶	‰∫åÈöéÂ†ÇÂ§¢|Êú¨‰π°Áà±|Êú¨ÈÉ∑ÊÑõ
ÂÑøÁéâÁé≤Â•à	ÂÖêÁéâ„Çå„Å™
Êû´ËäôÁà±	Ê•ì„Åµ„ÅÜ„ÅÇ
ÈÄ¢ËßÅÊ¢®Ëä±	ÈÄ¢Ë¶ã„É™„Ç´
È£éÈó¥Áî±Áæé	È¢®Èñì„ÇÜ„Åø
ÈÄ¢ÊúàÊó•Ëëµ	ÈÄ¢Êúà„Å≤„Åæ„Çä
ÂØåÂÆâÁé≤‰∫éÂ•à	ÂÜ®ÂÆâ„Çå„Åä„Å™
ÁªÄÈáéÂÖâ	Á¥∫Èáé„Å≤„Åã„Çã
ÂÜà‰∫ïËêåÂçé	ÂÜÜ‰∫ïËêåËèØ
Ê†πÂ∞æÊòéÈáå	Ê†πÂ∞æ„ÅÇ„Åã„Çä
ÂÆ´ÂüéÁêÜÊÉ†	ÂÆÆÂüé„Çä„Åà
ÂÆ´Â≤õËäΩË°£	ÂÆÆÂ≥∂„ÇÅ„ÅÑ
Â∑•Ëó§ÊãâÊãâ	Â∑•Ëó§„É©„É©
Â∑•Ëó§ÁæéÁ∫±	Â∑•Ëó§ÁæéÁ¥ó
ÂÆ´Ë•øÂÖâ	ÂÆÆË•ø„Å≤„Åã„Çã
ÂÆ´‰∏ãÁé≤Â•à	ÂÆÆ‰∏ãÁé≤Â•à
ÂÆ´Ê≥ΩÂçÉÊò•	ÂÆÆÊ≤¢„Å°„ÅØ„Çã
ÂπøÊøëÂÖâÂ∏å	Â∫ÉÁÄ¨„Åø„Å§„Åç
ÂπøÊøëËé≤	Â∫ÉÁÄ¨ËìÆ
Ê≤≥ÂåóÊúùÈò≥	Ê≤≥Âåó„ÅÇ„Åï„Å≤
Ê≤≥ÂêàÊòéÊó•Ëèú	Ê≤≥Âêà„ÅÇ„Åô„Å™
Ê≤≥ÂçóÂÆûÈáå	Ê≤≥ÂçóÂÆüÈáå
ÈªëÂ∑ùÂ†á	ÈªíÂ∑ù„Åô„Åø„Çå|Á®ªÂ∑ùÂ§èÁõÆ|Á®≤Â∑ù„Å™„Å§„ÇÅ
ÈªëÊú®‰∏ÄÈ¶ô	ÈªíÊú®„ÅÑ„Å°„Åã
Ê®™ÂÆ´‰∏ÉÊµ∑	Ê®™ÂÆÆ‰∏ÉÊµ∑
ËÉ°Ê°ÉÊ®±	ËÉ°Ê°É„Åï„Åè„Çâ
Ëä±Áã©Ëàû	Ëä±Áã©„Åæ„ÅÑ
Ëä±Ê≥ΩÊó•Ëëµ	Ëä±Ê≤¢„Å≤„Åæ„Çä|Êú®‰∏ãÊó•Ëëµ|Êú®‰∏ã„Å≤„Åæ„Çä
ÁöáÊüöÂ≠ê	Áöá„ÇÜ„Åö
ÂêâÂ∑ùÁà±Áæé	ÂêâÂ∑ù„ÅÇ„ÅÑ„Åø
ÂêâÈ´òÂÆÅÂÆÅ	ÂêâÈ´òÂØß„ÄÖ
ÂêâÊ†πÊüöËéâÁà±	ÂêâÊ†π„ÇÜ„Çä„ÅÇ
ÂêâËâØÈìÉ	ÂêâËâØ„Çä„Çì
ËøπÁæéÊú±Èáå	Ë∑°Áæé„Åó„ÇÖ„Çä
Âß¨Âí≤Âçé	Âß´Âí≤„ÅØ„Å™
ÂêâÊ∞∏Â•ΩÁæé	ÂêâÊ∞∏„Åì„ÅÆ„Åø
‰Ω≥ËãóÁêâËä±	‰Ω≥Ëãó„Çã„Åã
Êû∂‰πÉÁî±ÁΩó	Êû∂‰πÉ„ÇÜ„Çâ
Âä†Ëó§Áª´Èáé	Âä†Ëó§„ÅÇ„ÇÑ„ÅÆ
Â≤¨Ê®±	Â≤¨„Åï„Åè„Çâ
Á¨ïÁ∫Ø	Á≠ß„Ç∏„É•„É≥|Èπ´Â∞æËäΩË°£|È∑≤Â∞æ„ÇÅ„ÅÑ
ËèÖÈáéÊùæÈõ™	ËèÖÈáé„Åï„ÇÜ„Åç
ÁªìÂüéËéâ‰πÉ	ÁµêÂüé„Çä„ÅÆ
ÁªìÂüéÁæé‰Ωê	ÁµêÂüé„Åø„Åï
ÁöÜÊøëÊòéÈáå	ÁöÜÁÄ¨„ÅÇ„Åã„Çä
ÁöÜÊúàÂÖâ	ÁöÜÊúà„Å≤„Åã„Çã
‰πùÊù°Êª°	‰πùÊù°„Åø„Å°„Çã
Èπ´Â∞æËäΩË°£	È∑≤Â∞æ„ÇÅ„ÅÑ|Á¨ïÁ∫Ø|Á≠ß„Ç∏„É•„É≥
‰πùÈáéÈõè‰πÉ	‰πùÈáé„Å≤„Å™„ÅÆ
Â†ÄÂí≤ËéâÂ®Ö	Â†ÄÂí≤„Çä„ÅÇ
Â†ÄÊ≥ΩËåâÁî±	Â†ÄÊ≤¢ËåâÁî±
ËëµÂè∏	Ëëµ„Å§„Åã„Åï
Ëëµ‰ºäÂêπ	Ëëµ„ÅÑ„Å∂„Åç|ÁøºËëµ|Áøº„ÅÇ„Åä„ÅÑ
ÊøëÂêçÊ≠•	ÁÄ¨Âêç„ÅÇ„ÇÜ„ÇÄ
ÊøëÂêçÂÖâ	ÁÄ¨Âêç„Å≤„Åã„Çä
ÊøëÁî∞‰∏ÄËä±	ÁÄ¨Áî∞‰∏ÄËä±
Ëïæ	„Å§„Åº„Åø
Á´ãËä±ÁæéÂáâ	Á´ãËä±ÁæéÊ∂º
ÂáâÂÆ´Áê¥Èü≥	Ê∂ºÂÆÆÁê¥Èü≥
Áª´ÊøëÂøÉ	Á∂æÁÄ¨„Åì„Åì„Çç
ÈìÉÊú®ÂøÉÊò•	Èà¥Êú®ÂøÉÊò•
ÈìÉÈü≥ÈìÉ	Èà¥Èü≥„Çä„Çì
ÈìÉÂéüÁà±ËúúËéâ	ÈìÉÂéü„Ç®„Éü„É™
ÈìÉÂéüÁæéÂÖ∞	Èà¥Âéü„Åø„Çâ„Çì
Áë†Â∑ùÈáåËèú	Áë†Â∑ù„É™„Éä
Ê≥∑Â∑ùËä±Èü≥	ÁÄßÂ∑ùËä±Èü≥
ËêùÁê≥Ëä±ÊÅã	„É≠„Éº„É¨„É≥Ëä±ÊÅã
È∫ª‰ªì‰ºò	È∫ªÂÄâÊÜÇ
ÁæéÊ≥¢ÈÇ£Áæé	ÁæéÊ≥¢„Å™„Åø
ÁæéÊ≥¢Ê°É	ÁæéÊ≥¢„ÇÇ„ÇÇ
ÁæéÈõè	„Åø„Å≤„Å™|Ê∞∏‰∫ïÁæéÈõè|Ê∞∏‰∫ï„Åø„Å≤„Å™
ÁæéÈáåÊúâÁ∫±	ÁæéÈáåÊúâÁ¥ó
Áæé‰πÉÈõÄ	Áæé‰πÉ„Åô„Åö„ÇÅ
ÁæéÁ•ûËëµ	ÁæéÁ•û„ÅÇ„Åä„ÅÑ
ÁæéÂí≤ÁªìË°£	ÁæéÂí≤ÁµêË°£
ÁæéÂõ≠ÂíåËä±	ÁæéÂúíÂíåËä±
Áæé‰πãÂ≤õÊÉ†ÁêÜ	Áæé„ÉéÂ∂ã„ÇÅ„Åê„Çä
ÁæéÁ´πÈìÉ	ÁæéÁ´π„Åô„Åö
Ê¢¶ËßÅÈú≤	Â§¢Ë¶ã„Çã„ÅÖ
Ê¢¶‰πÉÁà±Âçé	Â§¢‰πÉ„ÅÇ„ÅÑ„Åã
Âº•ÁîüÁæéÊúà	Âº•Áîü„Åø„Å•„Åç
ÊòéÊó•ËßÅÊú™Êù•	ÊòéÊó•Ë¶ãÊú™Êù•
Êú´ÂπøÁ∫Ø	Êú´Â∫ÉÁ¥î
Êú®‰∏ãÂáõÂáõÂ≠ê	Êú®‰∏ãÂáõ„ÄÖÂ≠ê
Êú®‰∏ãÊó•Ëëµ	Êú®‰∏ã„Å≤„Åæ„Çä|Ëä±Ê≥ΩÊó•Ëëµ|Ëä±Ê≤¢„Å≤„Åæ„Çä
ÂçóÊù°‰∏ÄÈ¶ô	ÂçóÊù°„ÅÑ„Å°„Åã
‰∏ÉÊµ∑Èõè	‰∏ÉÊµ∑„Å≤„Å™
Â¥éÊÉ†Ê¢®È¶ô	Â∞æÂ¥é„Åà„Çä„Åã
‰∏ÉÊøëÁà±‰∏Ω‰∏ù	‰∏ÉÁÄ¨„Ç¢„É™„Çπ
‰∏ÉÊøë‰ºäÁªá	‰∏ÉÁÄ¨„ÅÑ„Åä„Çä
‰∏ÉÊ≥ΩÁæé‰∫ö	‰∏ÉÊ≤¢„Åø„ÅÇ
ÂâçÁî∞È¶ôÁªá	ÂâçÁî∞„Åã„Åä„Çä
ÈùíÁ©∫ÂÖâ	ÈùíÁ©∫„Å≤„Åã„Çä
‰∏òÊÉ†ÁêÜÂ•à	‰∏ò„Åà„Çä„Å™
‰ªÅÁßëÁôæÂçé	‰ªÅÁßëÁôæËèØ
Êó•ÂêëÊû´	Êó•Âêë„Åã„Åà„Åß
Êó•ÂêëÁî±ËâØ	Êó•Âêë„ÇÜ„Çâ
Êó•ÂêëÁúüÂáõ	„Å≤„Å™„Åü„Åæ„Çä„Çì
Ëç£Â∑ù‰πÉ‰∫ö	Ê†ÑÂ∑ù‰πÉ‰∫ú
ÂÆçÊà∑ÈáåÂ∏Ü	ÂÆçÊà∏ÈáåÂ∏Ü
Ëã•ÂÆ´Á©ó‰πÉ	Ëã•ÂÆÆÁ©Ç‰πÉ
‰∏âËà©ÁæéÈìÉ	‰∏âËà©„Åø„Åô„Åö
‰∏âÊµ¶Ê≠•Áæé	‰∏âÊµ¶Ê≠©Áæé
‰∏âÁî∞Ê®±	‰∏âÁî∞„Çµ„ÇØ„É©
‰∏âÂ∞æÊÉ†	‰∏âÂ∞æ„ÇÅ„Åê
‰∏âÂè∂ÂçÉÊò•	‰∏âËëâ„Å°„ÅØ„Çã
Ê£ÆÂ∑ùÁéâÁª™	Ê£ÆÂ∑ùÁéâÁ∑í
Á∫±‰ªìÁúüËèú	Á¥óÂÄâ„Åæ„Å™
Ê≤ôÊúàËäΩË°£	„Åï„Å§„ÅçËäΩË°£
‰∏äÂùÇËäΩË°£	‰∏äÂùÇ„ÇÅ„ÅÑ
‰∏äÁæΩÁªö	‰∏äÁæΩÁµ¢
‰∏äÂéü‰∫öË°£	‰∏äÂéü‰∫úË°£
Ê∂âË∞∑ÁæéÂ∏å	Ê∏ãË∞∑ÁæéÂ∏å
Á•ûÁ∫≥Ëä±	Á•ûÁ¥çËä±
Ê∑±Áî∞ÁªìÊ¢®	Ê∑±Áî∞ÁµêÊ¢®
Á•ûÈõ™	Á•û„É¶„Ç≠
Â∏ÇÂ∑ùÈõÖÁæé	Â∏ÇÂ∑ù„Åæ„Åï„Åø
‰ººÈ∏üÊó•Ëèú	‰ººÈ≥•Êó•Ëèú
Êó∂Áî∞‰∫öÁæé	ÊôÇÁî∞‰∫úÁæé
Êû¢Êú®Ëëµ	Êû¢Êú®„ÅÇ„Åä„ÅÑ
Ê∞¥Â≤õÊ¥•ÂÆû	Ê∞¥Â∂ã„ÅÇ„Åö„Åø
Ê∞¥Êà∑È¶ôÂ•à	Ê∞¥Êà∏„Åã„Å™
Ê∞¥Êó†Êøë‰ºòÂ§è	„Åø„Å™„ÅõÂÑ™Â§è
Ê∞¥ÈáéÊúùÈò≥	Ê∞¥ÈáéÊúùÈôΩ
Ê∞¥ÂéüÁæéÂõ≠	Ê∞¥Âéü„Åø„Åù„ÅÆ
Ê∞¥Ê≥Ω‰πÉ‰πÉ	Ê∞¥Ê≤¢„ÅÆ„ÅÆ
ÂõõÂÆ´Áà±‰∏Ω‰∏ù	ÂõõÂÆÆ„ÅÇ„Çä„Åô
ÊùæÊú¨ËèúÂ•àÂÆû	ÊùæÊú¨ËèúÂ•àÂÆü
ÊùæÊú¨‰∏ÄÈ¶ô	ÊùæÊú¨„ÅÑ„Å°„Åã
ÊùæÂÜàÂçÉËèú	ÊùæÂ≤°„Å°„Å™
Êùæ‰∫ï‰ºòÂ≠ê	Êùæ‰∫ïÂÑ™Â≠ê
Á©óÈ´òÁªìËä±	Á©ÇÈ´òÁµêËä±
Á©óÈ´òÊúâÁ∫™	Á©ÇÈ´ò„ÇÜ„ÅÜ„Åç
Á©óËä±Áà±Èáå	Á©ÇËä±„ÅÇ„ÅÑ„Çä
Ê°ÉÂ∞ªÈ¶ôÂêçËäΩ	Ê°ÉÂ∞ª„Åã„Å™„ÇÅ
Ê°ÉÊøëÂèãÊ¢®Â•à	Ê°ÉÁÄ¨ÂèãÊ¢®Â•à
Ê°ÉÂõ≠ÊÄúÂ•à	Ê°ÉÂúíÊÄúÂ•à
Ëó§ÁéØÂ•à	Ëó§„Åã„Çì„Å™
Ëó§‰∫ïÁà±Á∫±	Ëó§‰∫ï„ÅÇ„ÅÑ„Åï
Ëó§‰∫ï‰∏ÄÂ§ú	Ëó§‰∫ï„ÅÑ„Çà„Å™
Ëó§Êµ¶ÊÉ†	Ëó§Êµ¶„ÇÅ„Åê
Â§©ÂÆ´Ëä±Âçó	Â§©ÂÆÆËä±Âçó
Â§©Êô¥‰πÉÁà±	Â§©Êô¥‰πÉÊÑõ
Â§©‰Ωø‰∫öÊ¢¶	„ÅÇ„Åæ„Å§„Åã‰∫úÂ§¢
Â§©Èü≥ÂîØ	Â§©Èü≥„ÇÜ„ÅÑ
Áî∞‰∏≠ÂÆÅÂÆÅ	Áî∞‰∏≠„Å≠„Å≠
Ê°êË∞∑ËåâËéâ	|Ê°êË∞∑„Åæ„Å§„Çä
Êú™Ê≠•Â•àÂ•à	Êú™Ê≠©„Å™„Å™
ÂîØ‰∫ïÁúüÂØª	ÂîØ‰∫ï„Åæ„Å≤„Çç
‰∫îÂçÅÂ≤öÂ§è	‰∫îÂçÅÂµê„Å™„Å§
ËàûÂéüÂú£	ËàûÂéüËÅñ
Ë•øÂÆ´Â•ΩÁæé	Ë•øÂÆÆ„Åì„ÅÆ„Åø
Ê±ê‰∏ñ	ÊúâÊ†ñËä±ÁªØ|ÊúâÊ†ñËä±„ÅÇ„Åã
Â∏åÂí≤ËâæÁéõ	Â∏åÂí≤„Ç®„Éû
Â∏åÂí≤‰∫öÈáåÂ≠ê	Â∏åÂí≤„Ç¢„É™„Çπ
Ë•øÈáéÊòüÂ§è	Ë•øÈáé„Çª„Ç§„Éä
Ë•øÂÖÉÊòéÊ≤ô	Ë•øÂÖÉ„ÇÅ„ÅÑ„Åï
Â∏åÂøóÁà±Èáé	Â∏åÂøó„ÅÇ„ÅÑ„ÅÆ
Â§èÊú®Áé≤	Â§èÊú®„Çä„Çì
Â§èÁõÆÂìç	Â§èÁõÆÈüø
È¶ôÊæÑÊûúÁ©ó	„Åã„Åô„ÅøÊûúÁ©Ç
È¶ôÊæÑËéâÂ≠ê	È¶ôÊæÑ„Çä„Åì
È¶ôÊ∞¥Á∫Ø	È¶ôÊ∞¥„Åò„ÇÖ„Çì
Áõ∏Ê≥ΩËéâÂ®ú	Áõ∏Êæ§„É™„Éä
Â∞è‰ªì‰∏ÉÊµ∑	Â∞èÂÄâ‰∏ÉÊµ∑
Â∞è‰ªìÁî±Ëèú	Â∞èÂÄâÁî±Ëèú
Â∞èÂ∑ùÈòø‰ΩêÁæé	Â∞èÂ∑ù„ÅÇ„ÅïÁæé
Â∞èÂ≤õÁ∫ØÂêç	Â∞èÂ∂ã„Ç∏„É•„É≥„Éä
ÁØ†ÊÉ†Áæé	ÁØ†„ÇÅ„Åê„Åø
Â∞èÊ†óÁæé‰ºò	Â∞èÊ†ó„Åø„ÇÜ
Â∞èÊ¢ÖÊÉ†Â•à	Â∞èÊ¢Ö„Åà„Å™
Â∞èÊ≥âÊó•Âêë	Â∞èÊ≥â„Å≤„Å™„Åü
Á≠±Áî∞‰ºò	ÁØ†Áî∞„ÇÜ„ÅÜ
Êñ∞ÊùëÊú±Èáå	Êñ∞Êùë„ÅÇ„Åã„Çä
Êñ∞‰∫ïÈáåÁúü	Êñ∞‰∫ï„É™„Éû
ÊòüÂ•àÁà±	ÊòüÂ•à„ÅÇ„ÅÑ
ËäΩÊ£ÆÊª¥	ËäΩÊ£Æ„Åó„Åö„Åè
Âè∂Áà±	Âè∂ÊÑõ
Âè∂È£é‰ºòËéâ‰∫ö	ËëâÈ¢®„ÇÜ„Çä„ÅÇ
Âè∂ÊúàÂáâÂ≠ê	ËëâÊúàÊ∂ºÂ≠ê
‰πôÁà±‰∏Ω‰∏ù	‰πô„Ç¢„É™„Çπ
‰ºä‰∏úÂçÉÂ•àÁæé	‰ºäÊù±„Å°„Å™„Åø
‰∏ÄÂÆ´Â∏åÂ∏Ü	‰∏ÄÂÆÆÂ∏åÂ∏Ü
‰ºäË¥∫ÁúüÂ≠ê	‰ºäË≥Ä„Åæ„Åì
ÁøºËëµ	Áøº„ÅÇ„Åä„ÅÑ|Ëëµ‰ºäÂêπ|Ëëµ„ÅÑ„Å∂„Åç
‰∏Ä‰πÉËëµ	‰∏Ä‰πÉ„ÅÇ„Åä„ÅÑ
‰ºäËó§Ê≤ô‰πüÈ¶ô	„ÅÜ„Çì„Å±„ÅÑ
‰ºäËó§Âú£Â§è	‰ºäËó§ËÅñÂ§è
‰ºäÁªáÈõè‰πÉ	‰ºäÁπî„Å≤„Å™„ÅÆ
‰∏Ä‰πãÊøëÊ¢ì	‰∏Ä„ÉéÁÄ¨Ê¢ì
‰ºäÁªáÁæΩÈü≥	‰ºäÁπîÁæΩÈü≥
Ê®±‰∫ïËâæËúúËéâ	Ê°ú‰∫ï„Ç®„Éü„É™
Ê®±Êú®‰ºòÂ∏åÈü≥	Ê°úÊú®ÂÑ™Â∏åÈü≥
Ê®±ÂøÉÁæé	Ê°ú„Åì„Åì„Åø
Ê®±Áî±ÁΩó	„Åï„Åè„Çâ„ÇÜ„Çâ
Ê∞∏‰∫ïÁéõÂà©‰∫ö	Ê∞∏‰∫ï„Éû„É™„Ç¢
Ê∞∏ÊøëÂîØ	Ê∞∏ÁÄ¨„ÇÜ„ÅÑ
Áî±Áà±ÂèØÂ•à	Áî±ÊÑõÂèØÂ•à
ÊúâÂÜàÁæéÁæΩ	ÊúâÂ≤°„Åø„ÅÜ
‰ºòÊ¢®ËàûÂ•à	ÂÑ™Ê¢®„Åæ„ÅÑ„Å™
ÊúâÊ†ñËä±ÁªØ	ÊúâÊ†ñËä±„ÅÇ„Åã|Ê±ê‰∏ñ
ÊÇ†Á∫±ÊúâÊú±	ÊÇ†Á¥ó„ÅÇ„Çä„Åô
ÊüöÊúà‰∫öË°£	ÊüöÊúà„ÅÇ„ÅÑ
Èõ®ÂÆ´Áê¥Èü≥	Èõ®ÂÆÆÁê¥Èü≥
ÁéâÂêçÁæéËâØ	ÁéâÂêç„Åø„Çâ
‰∏éÁî∞Ê®±	‰∏éÁî∞„Åï„Åè„Çâ
ÁæΩÂí≤ÁæéÊô¥	ÁæΩÂí≤„Åø„ÅØ„Çã
ÊúàËßÅ‰ºäÁªá	ÊúàË¶ã‰ºäÁπî
Êúà‰πÉÈõè	Êúà‰πÉ„Å≤„Å™
Êúà‰πÉÈú≤Â®ú	Êúà‰πÉ„É´„Éä
ÊúàÈáéÈúû	ÊúàÈáé„Åã„Åô„Åø
Êó©ÈáéËØó	„ÅØ„ÇÑ„ÅÆ„ÅÜ„Åü
Êó©‰πôÂ•≥Èú≤‰æù	Êó©‰πôÂ•≥„É´„Ç§
ÊñãËó§‰∫öÁæéÈáå	ÊñéËó§„ÅÇ„Åø„Çä
ÈïøÊ≥ΩÊ¢ì	Èï∑Êæ§„ÅÇ„Åö„Åï
ÁúüÁôΩÁà±Ê¢®	ÁúüÁôΩÊÑõÊ¢®
ÁúüÁôΩÂ∏åÂÆû	ÁúüÁôΩÂ∏åÂÆü
Áü•Ëä±Ê¢ÖËéé	Áü•Ëä±„É°„Ç§„Çµ
ÁªáÁî∞ÁúüÂ≠ê	ÁπîÁî∞ÁúüÂ≠ê
‰ª≤ÊùëÁæéÁæΩ	‰ª≤Êùë„Åø„ÅÜ
ÊüäÊú®Êû´	ÊüäÊú®Ê•ì
‰∏≠Â±±ÊñáÈ¶ô	‰∏≠Â±±„Åµ„Åø„Åã
Ê∏öÂÖâÂ∏å	Ê∏ö„Åø„Å§„Åç
Á´πÂÜÖÁà±	Á´πÂÜÖ„ÅÇ„ÅÑ
Á´πÂÜÖ‰πÉÁà±	Á´πÂÜÖ‰πÉÊÑõ
Á´πÁî∞Ê¢¶	Á´πÁî∞„ÇÜ„ÇÅ
Êú±Èü≥ÂîØ	Êú±Èü≥„ÇÜ„ÅÑ
Ê¢ìÂÖâËéâ	Ê¢ì„Éí„Ç´„É™
‰ΩêÂ±±Áà±	‰ΩêÂ±±ÊÑõ
‰Ωê‰ΩêÊú®ÊòéÂ∏å	‰Ωê„ÄÖÊú®„ÅÇ„Åç
ÊùæÊú¨Ê¢®Á©ó	ÊùæÊú¨Ê¢®Á©Ç
‰ΩêÈáéÁî±Áúü	‰ΩêÈáé„ÇÜ„Åæ
Â§©Â∑ùÁ©∫	Â§©Â∑ù„Åù„Çâ
ÂÆ´ÊøëÈáåÂ≠ê	ÂÆÆÁÄ¨„É™„Ç≥
Ê¢¶ÂÆûÈ¶ôËãó	Â§¢ÂÆü„Åã„Å™„Åà
Âä≥‰º¶Ëä±ÊÅã	„É≠„Éº„É¨„É≥Ëä±ÊÅã
ÁæéÂí≤‰Ω≥Â•à	ÁæéÂí≤„Åã„Çì„Å™
Ë∞¢ËÄ≥Êúµ	Sheldon
Ë∞¢Â∞îÈ°ø	Sheldon
Sheldon	Ë∞¢Â∞îÈ°ø|Ë∞¢ËÄ≥Êúµ
Ëé±Á∫≥Âæ∑	Leonard
Leonard	Ëé±Á∫≥Âæ∑
‰Ω©Â¶Æ	Penny
Penny	‰Ω©Â¶Æ
‰ºØÁ∫≥ÈªõÁâπ	Bernadette
Bernadette	‰ºØÁ∫≥ÈªõÁâπ
ËâæÁ±≥	Amy
Amy	ËâæÁ±≥
ÈúçÂçéÂæ∑	Howard
Howard	ÈúçÂçéÂæ∑
ÊãâÊù∞‰ªÄ	Rajesh
Rajesh	ÊãâÊù∞‰ªÄ
ÁëûÁßã	Rachel
Rachel	ÁëûÁßã
Ëé´Â¶ÆÂç°	Monica
Monica	Ëé´Â¶ÆÂç°
‰πî‰ºä	Joey
Joey	‰πî‰ºä
ÁΩóÊñØ	Ross
Ross	ÁΩóÊñØ
Èí±Âæ∑Âãí	Chandler
Chandler	Èí±Âæ∑Âãí
Ëè≤ÊØî	Phoebe
Phoebe	Ëè≤ÊØî
cmd	Command|‚åò
command	‚åò
Ctrl	Control|‚åÉ
control	‚åÉ
Opt	Option|‚å•
option	‚å•
shift	‚áß
tab	‚á•|	
Caps	CapsLock|‚á™
CapsLock	‚á™
return	‚èé
enter	‚èé
space	‚ê£
backspace	‚å´
Del	Delete|‚å´
delete	‚å´
Esc	Escape|‚éã
eject	‚èè
‰∏§‰∏™ÁÅ´	ÁÇé|ÁÇè
‰∏§‰∏™Âúü	Âú≠
‰∏§‰∏™‰∏Ä	‰∫å
‰∏§‰∏™‰∫å	‰∫ñ
‰∏§‰∏™Â±±	Â≤Ä|Â±æ
‰∏§‰∏™Âè£	Âêï|ÂêÖ
‰∏§‰∏™Áî∞	Áïï
‰∏§‰∏™‰πù	†Éô
‰∏§‰∏™È£û	†Éß
‰∏§‰∏™Êàà	Êàî
‰∏§‰∏™ÂÖÄ	†Äò
‰∏§‰∏™°•¶	°¶™
‰∏§‰∏™Â∑æ	¢Åù
‰∏§‰∏™Â∑¶	¢Ä°
‰∏§‰∏™ÊØç	£´Ø
‰∏§‰∏™Êù•	†êá
‰∏§‰∏™Âá°	†òª
‰∏§‰∏™Â§ï	Â§ö|°ñá
‰∏§‰∏™ÂΩê	¢ëë
‰∏§‰∏™¢éò	¢éô
‰∏§‰∏™Êòé	£äß
‰∏§‰∏™Êúø	Ê£ò|Ê£ó
‰∏§‰∏™‰πÇ	Áàª
‰∏§‰∏™Êõ∞	Êòå
‰∏§‰∏™Â∞∏	°∞≤
‰∏§‰∏™ÂÖ´	†îÅ
‰∏§‰∏™ËÄå	¶ìî
‰∏§‰∏™Áæä	´Öì
‰∏§‰∏™È©¨	©•ã
‰∏§‰∏™ÂçÖ	¢åΩ
‰∏§‰∏™Â∑õ	°ø≠
‰∏§‰∏™ÊØî	£¨Ö
‰∏§‰∏™Áî≥	§±ì
‰∏§‰∏™‰Ωô	†é≥
‰∏§‰∏™ÁΩí	ÆäÇ
‰∏§‰∏™„êÖ	¨ºÜ
‰∏§‰∏™Èáë	ÈçÇ
‰∏§‰∏™Êú®	Êûó
‰∏§‰∏™Ê∞¥	Ê≤ù
‰∏§‰∏™È¢®	‰¨ï
‰∏§‰∏™Áü≥	Á†≥
‰∏§‰∏™Êó•	Êòç
‰∏§‰∏™Êúà	Êúã
‰∏§‰∏™ÁõÆ	‰Ä†
‰∏§‰∏™ÁôΩ	„øü
‰∏§‰∏™Áôæ	Áöï
‰∏§‰∏™ËÄ≥	ËÅë
‰∏§‰∏™Â±Æ	Ëâ∏
‰∏§‰∏™Âªø	†¶ú
‰∏§‰∏™ÂçÑ	Âçå
‰∏§‰∏™Ëô´	‰ñµ
‰∏§‰∏™È≠ö	‰≤Ü|©∫∞
‰∏§‰∏™Áâõ	Áâ™|§òß
‰∏§‰∏™Ëôé	Ëô§
‰∏§‰∏™Èæç	Èæñ
‰∏§‰∏™È¶¨	È®≥
‰∏§‰∏™Áä¨	„πú
‰∏§‰∏™‰∫∫	‰ªé|‰ªå
‰∏§‰∏™ÂÖ•	†ìú
‰∏§‰∏™‰π†	ÁæΩ
‰∏§‰∏™Âç™	†®ñ
‰∏§‰∏™„îæ	†®é
‰∏§‰∏™Âá†	†ò¨
‰∏§‰∏™‰πô	†Éê
‰∏§‰∏™Â§ß	Â§∂|„öê
‰∏§‰∏™Â§´	„öò
‰∏§‰∏™Á¶æ	Áßù
‰∏§‰∏™Âπ≤	Âπµ
‰∏§‰∏™‰∫ï	„ê©
‰∏§‰∏™Êñ§	Êñ¶
‰∏§‰∏™Áâá	„∏û
‰∏§‰∏™Áâô	§òÜ
‰∏§‰∏™ÁÇé	Ááö
‰∏§‰∏™Âºì	Âºú
‰∏§‰∏™Ê∞∏	£¥è
‰∏§‰∏™‰∫¶	†ÖØ
‰∏§‰∏™Êâã	¢™í|Êäô
‰∏§‰∏™ÊØõ	„≤é
‰∏§‰∏™Áéã	Áé®
‰∏§‰∏™Áî∑	§≤∂
‰∏§‰∏™Â•≥	Â•ª|„ö£
‰∏§‰∏™Âèà	Âèå|„ïõ
‰∏§‰∏™ÊîØ	¢∫∏
‰∏§‰∏™Èöª	‰®á
‰∏§‰∏™Âè§	†≥¨
‰∏§‰∏™Âêâ	ÂñÜ|°îØ
‰∏§‰∏™Ëàå	¶ßö
‰∏§‰∏™Ë®Ä	Ë™©|ß®ü
‰∏§‰∏™Êà∑	¢®Ø|¢®≥
‰∏§‰∏™ÂêØ	¢©ô
‰∏§‰∏™‰æÜ	„Ø§
‰∏§‰∏™Ê°º	£†¨
‰∏§‰∏™Êó°	ÂÖì
‰∏§‰∏™Ê≠π	„±õ
‰∏§‰∏™Âé∂	Âé∏|„ïï
‰∏§‰∏™Âåï	ÊØî
‰∏§‰∏™Âπ∫	¢Ü∂
‰∏§‰∏™ÁéÑ	ÁéÜ
‰∏§‰∏™ÂøÉ	¢ó∞
‰∏§‰∏™Âäõ	††¥
‰∏§‰∏™Ê¨†	£¢ê
‰∏§‰∏™Â≠ê	Â≠ñ
‰∏§‰∏™‰∫à	„ê®
‰∏§‰∏™‰∫´	„ùá
‰∏§‰∏™Á´ã	Á´ù
‰∏§‰∏™Èü≥	‰™≠
‰∏§‰∏™Á´ü	Á´∏
‰∏§‰∏™Á´û	Á´∂
‰∏§‰∏™ÂÖÑ	„í≠
‰∏§‰∏™Ë¶ã	Ë¶û
‰∏§‰∏™Ë≤ù	Ë≥è
‰∏§‰∏™Ëæõ	Ëæ°
‰∏§‰∏™Áìú	„ºå
‰∏§‰∏™ÂëÜ	Êßë
‰∏§‰∏™Êûú	£õï
‰∏§‰∏™È∏ü	™Öù
‰∏§‰∏™Â∑¢	¢Äå
‰∏§‰∏™Á¶∫	•ùâ
‰∏§‰∏™Â∑ø	¢Çè
‰∏§‰∏™Âè•	†£™
‰∏§‰∏™Â•á	„ö°
‰∏§‰∏™Áúü	„íπ
‰∏§‰∏™Â∞π	°±â
‰∏§‰∏™Êòî	£ä£
‰∏§‰∏™Êòì	£ä∑
‰∏§‰∏™Ëá£	¶£¶|´áÜ
‰∏§‰∏™Èù¢	©à≥|©à≤
‰∏§‰∏™ÂÖà	ÂÖü
‰∏§‰∏™ËÄÅ	‰éú
‰∏§‰∏™Á§∫	Á•ò
‰∏§‰∏™Ëá≥	Ëá∏
‰∏§‰∏™Áîü	Áî°
‰∏§‰∏™Ëªä	‰°õ
‰∏§‰∏™Ë∂≥	Ë∏Ä
‰∏§‰∏™ÂçÄ	†•∫
‰∏§‰∏™È¶ô	©°ê|©°å
‰∏§‰∏™Èöπ	Èõî
‰∏§‰∏™Áâü	§öÖ
‰∏§‰∏™Ë±ï	Ë±©
‰∏§‰∏™†Ç¢	†ÉÑ
‰∏§‰∏™Áïê	„Ω¨
‰∏§‰∏™„£á	„£à
‰∏§‰∏™ÈÇë	‰£à
‰∏§‰∏™Â†Ø	„öÅ
‰∏§‰∏™Áßâ	•°ù
‰∏§‰∏™ÂÄâ	†ëê
‰∏§‰∏™Êù±	„Ø•
‰∏§‰∏™ÂñÑ	°ÜÉ
‰∏§‰∏™ÂÉâ	†ë≤
‰∏§‰∏™ÈΩí	™ôπ
‰∏§‰∏™Âñú	Âõç
‰∏§‰∏™Ëµ∞	ßºÇ
‰∏§‰∏™Ê≠¢	£•ñ|£•ï
‰∏§‰∏™Êòå	£ä´
‰∏§‰∏™‰∏≤	†Å∑
‰∏§‰∏™Á±≥	•π´
‰∏§‰∏™Êùü	£ó•|¨É∑
‰∏§‰∏™Èö∂	®Ωº
‰∏§‰∏™‰∏ç	´†≠
‰∏§‰∏™Èæô	±çÇ
‰∏§‰∏™‰πû	¨º†
‰∏§‰∏™Â§ã	≠ê™
‰∏§‰∏™Â§©	≠ëà
‰∏â‰∏™Áîü	„Ωì
‰∏â‰∏™Áß¶	‰Üê
‰∏â‰∏™Ëã•	‰ñÉ
‰∏â‰∏™Èõ≤	‰®∫
‰∏â‰∏™‰∫∫	‰ºó|„ê∫
‰∏â‰∏™ÂàÄ	Âàï
‰∏â‰∏™ÂçÅ	Âçâ|†¶Ñ
‰∏â‰∏™Âäõ	Âä¶
‰∏â‰∏™Âéü	Âéµ
‰∏â‰∏™Âé∂	ÂéΩ
‰∏â‰∏™Âèà	Âèí
‰∏â‰∏™Âè£	ÂìÅ|†±†
‰∏â‰∏™‰∏É	„êÇ
‰∏â‰∏™Âêâ	Âöû|°ïá
‰∏â‰∏™Âúü	Âûö
‰∏â‰∏™Â£´	Â£µ
‰∏â‰∏™Â•≥	Âß¶
‰∏â‰∏™Â≠ê	Â≠®|°•¶
‰∏â‰∏™Â∞è	Â∞õ|°≠Ø
‰∏â‰∏™ÂøÉ	ÊÉ¢
‰∏â‰∏™Êâã	Êé±
‰∏â‰∏™Êó•	Êô∂|Êôø
‰∏â‰∏™Êú®	Ê£Æ|£ìè
‰∏â‰∏™Ê≠¢	Ê≠Æ
‰∏â‰∏™ÊØõ	ÊØ≥
‰∏â‰∏™Ê∞¥	Ê∑º|„¥á
‰∏â‰∏™Ê≥â	ÁÅ•
‰∏â‰∏™ÁÅ´	ÁÑ±|„∑ã
‰∏â‰∏™Áâõ	Áäá
‰∏â‰∏™Áä¨	Áåã
‰∏â‰∏™Áî∞	Áïæ
‰∏â‰∏™ÁôΩ	Áöõ
‰∏â‰∏™ÁõÆ	Áûê
‰∏â‰∏™Áõ¥	Áüó
‰∏â‰∏™Áü≥	Á£ä
‰∏â‰∏™Áæä	Áæ¥
‰∏â‰∏™ËÄ≥	ËÅ∂
‰∏â‰∏™Ëàå	Ëàô|¶ßµ
‰∏â‰∏™Â±Æ	Ëäî
‰∏â‰∏™Ëô´	Ëü≤
‰∏â‰∏™Ë®Ä	Ë≠∂|ß≠õ
‰∏â‰∏™Ë¥ù	Ëµë
‰∏â‰∏™Ëªä	ËΩü
‰∏â‰∏™Èáë	Èë´
‰∏â‰∏™Èöπ	Èõ•|Èõ¶
‰∏â‰∏™Èõ∑	Èùê
‰∏â‰∏™È¢®	È£ç
‰∏â‰∏™È£õ	È£ù
‰∏â‰∏™È¶ô	È¶´
‰∏â‰∏™È©¨	È™â|©ß¢
‰∏â‰∏™È≠ö	È±ª
‰∏â‰∏™Èπø	È∫§
‰∏â‰∏™Èæç	Èæò
‰∏â‰∏™‰∏™	†Å≠
‰∏â‰∏™‰∏∂	†Åº
‰∏â‰∏™‰∫Ü	†Ñï
‰∏â‰∏™‰ªã	†åï
‰∏â‰∏™‰ºÅ	†ê∞
‰∏â‰∏™Ëàç	†ë∞
‰∏â‰∏™Âú•	†í∂
‰∏â‰∏™ÂÖâ	†ìâ
‰∏â‰∏™ÂÖî	†ìó
‰∏â‰∏™ÂÖ®	†ìæ
‰∏â‰∏™†ôΩ	†öõ
‰∏â‰∏™†ß™	†®ã
‰∏â‰∏™„îæ	†®ï
‰∏â‰∏™Âé°	†´í
‰∏â‰∏™ÂèØ	†æ≥
‰∏â‰∏™Âõ†	°à≤
‰∏â‰∏™Â§è	°ñÉ
‰∏â‰∏™Â§ß	°òô
‰∏â‰∏™Â§©	°ôé
‰∏â‰∏™Â§™	°ôí
‰∏â‰∏™¶âº	°ö§
‰∏â‰∏™ÂÆù	°¨è
‰∏â‰∏™ÂÆú	°¨ê
‰∏â‰∏™ÂÆ¢	°¨ö
‰∏â‰∏™ÂØí	°¨ú
‰∏â‰∏™Â∞ë	°Æè
‰∏â‰∏™Â±±	°∑à
‰∏â‰∏™Â∏Ç	¢Öà
‰∏â‰∏™Êñá	£Åï
‰∏â‰∏™Êñó	£Åæ
‰∏â‰∏™Êúø	£ùØ
‰∏â‰∏™Êùü	£†Ü
‰∏â‰∏™Êûó	£°ï
‰∏â‰∏™Êûú	£°ó
‰∏â‰∏™Ê¨†	££ì
‰∏â‰∏™£•ö	£¶¥
‰∏â‰∏™Áà™	§îô
‰∏â‰∏™Â¶•	§ïá
‰∏â‰∏™Áî®	§∞å
‰∏â‰∏™Áî≤	§≥Ö
‰∏â‰∏™Áôæ	§æ©
‰∏â‰∏™Áõñ	•É£
‰∏â‰∏™Áúå	•çô
‰∏â‰∏™Á©∫	•©å
‰∏â‰∏™‰∫á	•´Æ|•´ß
‰∏â‰∏™Á´π	•¥í
‰∏â‰∏™ÁΩí	¶ãπ
‰∏â‰∏™Áæó	¶è±
‰∏â‰∏™ËÄÅ	¶ìà
‰∏â‰∏™Êúà	¶ú≥
‰∏â‰∏™Ëá≥	¶•è
‰∏â‰∏™Ëàà	¶ßÖ
‰∏â‰∏™Ë∂≥	®Ü¨
‰∏â‰∏™„ññ	®ëÇ
‰∏â‰∏™ÈñÄ	®∑Æ
‰∏â‰∏™Èù¢	©âñ
‰∏â‰∏™È†Å	©ñè
‰∏â‰∏™È≥•	™àº
‰∏â‰∏™Áî∑	™üß
‰∏â‰∏™Á´ã	´Å™
‰∏â‰∏™‰πù	´°§
‰∏â‰∏™‰πü	´°©
‰∏â‰∏™Âä†	´¶π
‰∏â‰∏™Âãï	´¶ø
‰∏â‰∏™ÂçÉ	´ß¢
‰∏â‰∏™Êñπ	¨Äâ
‰∏â‰∏™Êúî	¨Çö
‰∏â‰∏™Áéâ	¨çº
‰∏â‰∏™Áî≥	¨èç
‰∏â‰∏™°ø®	Â∑õ
‰∏â‰∏™Âéª	†¨ë
‰∏â‰∏™Âºì	¢èù
‰∏â‰∏™‰ñù	ßîó
‰∏â‰∏™‰∏ø	ÂΩ°
‰∏â‰∏™Êà∑	¢©ï
‰∏â‰∏™Áìú	§¨ë
‰∏â‰∏™È∏ü	™âì
‰∏â‰∏™Á±≥	•º¨
Âõõ‰∏™‰πÇ	„∏ö
Âõõ‰∏™‰∫∫	†àå
Âõõ‰∏™Âé∂	†´¨
Âõõ‰∏™Âèà	Âèï
Âõõ‰∏™Âåï	£¨Ö
Âõõ‰∏™Â∑•	„†≠
Âõõ‰∏™Âè£	„óä
Âõõ‰∏™Â§©	°öå
Âõõ‰∏™Â∞è	°Æê
Âõõ‰∏™Â±Æ	Ëåª
Âõõ‰∏™ÁÅ´	Ááö
Âõõ‰∏™Áâõ	§õ≠
Âõõ‰∏™È≠ö	‰≤ú
Âõõ‰∏™Êúà	Êú§
Âõõ‰∏™Êó•	£ä´
Âõõ‰∏™Êõ∞	£ä≠
Âõõ‰∏™Êûó	£°Ω
Âõõ‰∏™Ê∞¥	„µò
Âõõ‰∏™Áü≥	•óâ
Âõõ‰∏™Áî∞	§≥≥
Âõõ‰∏™Áî≤	§≥µ
Âõõ‰∏™‰∏î	†Å†
Âõõ‰∏™Âõö	°à∂
Âõõ‰∏™Âõ∞	°àπ
Âõõ‰∏™Á´π	•∑π
Âõõ‰∏™ËÄÅ	¶ìã
Âõõ‰∏™Êúø	£°ç
Âõõ‰∏™ÂÖà	†ìô
Âõõ‰∏™Èáë	®∞ª
Âõõ‰∏™Ê≥â	§ÜÅ
Âõõ‰∏™Ë®Ä	ßÆ¶
Âõõ‰∏™ÈñÄ	®∑æ
Âõõ‰∏™Êûú	£°æ
Âõõ‰∏™Êò•	£å†
Âõõ‰∏™Ëªä	®èø
Âõõ‰∏™È¢®	©ô°
Âõõ‰∏™Èõ∑	‰®ª
Âõõ‰∏™Èõ≤	©áî
Âõõ‰∏™Ëàà	†îª
Âõõ‰∏™Èæç	™ö•
Âõõ‰∏™Âúü	„ôì
Ê∞¥	üí¶|H‚ÇÇO
‰∏ÄÊ∞ßÂåñ‰∫åÊ∞¢	H‚ÇÇO
ÈÖíÁ≤æ	C‚ÇÇH‚ÇÜO
‰πôÈÜá	C‚ÇÇH‚ÇÜO
Èî∞ÈÖ∏Èíæ	K‚ÇÇMnO‚ÇÑ
È´òÈî∞ÈÖ∏Èíæ	KMnO‚ÇÑ
Áü≥ÁÅ∞Áü≥	CaCO‚ÇÉ
Áü≥ÁÅ∞Ê∞¥	Ca(OH)‚ÇÇ
ËÉÜÁüæ	CuSO‚ÇÑ¬∑5H‚ÇÇO
‰∫åÊ∞ßÂåñÊ∞¢	H‚ÇÇO‚ÇÇ
Á∫ØÁ¢±	Na‚ÇÇCO‚ÇÉ
ÁÜüÁü≥ÁÅ∞	Ca(OH)‚ÇÇ
Ê∞®Ê∞¥	NH‚ÇÉ¬∑H‚ÇÇO
Á£∑ÈÖ∏	H‚ÇÉPO‚ÇÑ
Ëë°ËêÑÁ≥ñ	C‚ÇÜH‚ÇÅ‚ÇÇO‚ÇÜ
Á°´ÂåñÈí†	Na‚ÇÇS
ÁªøÁüæ	FeSO‚ÇÑ¬∑7H‚ÇÇO
Ê∞ØÈÖ∏Èíæ	KClO‚ÇÉ
ÊòéÁüæ	KAl(SO‚ÇÑ)‚ÇÇ¬∑12H‚ÇÇO
Á°ùÈÖ∏Èìµ	NH‚ÇÑNO‚ÇÉ
È£üÁõê	NaCl
Ê∞ßÂåñÈìÅ	Fe‚ÇÇO‚ÇÉ
ÈìúÁªø	Cu‚ÇÇ(OH)‚ÇÇCO‚ÇÉ
Á°´ÈÖ∏Èìú	CuSO‚ÇÑ
ÁÉßÁ¢±	NaOH
ËîóÁ≥ñ	C‚ÇÅ‚ÇÇH‚ÇÇ‚ÇÇO‚ÇÅ‚ÇÅ
Ê∞ßÂåñÈìù	Al‚ÇÇO‚ÇÉ
Âπ≤ÂÜ∞	CO‚ÇÇ
Á°´ÈÖ∏Èí†	Na‚ÇÇSO‚ÇÑ
‰∫öÁ°ùÈÖ∏Èí†	NaNO‚ÇÇ
Á∫§Áª¥Á¥†	(C‚ÇÜH‚ÇÅ‚ÇÄO‚ÇÖ)n
ÈìÅÁ≤â	Fe
‰∏âËÅöÊ∞∞ËÉ∫	C‚ÇÉH‚ÇÜN‚ÇÜ
‰∏ÅÁÉ∑	CH‚ÇÉCH‚ÇÇCH‚ÇÇCH‚ÇÉ
È£üÈÜã	CH‚ÇÉCOOH
ÈÜãÈÖ∏	CH‚ÇÉCOOH
Â≠îÈõÄÁü≥	Cu‚ÇÇ(OH)‚ÇÇCO‚ÇÉ
ËçâÊú®ÁÅ∞	K‚ÇÇCO‚ÇÉ
‰∏ôÁÉ∑	C‚ÇÉH‚Çà
‰∏ÄÊ∞ßÂåñÁ¢≥	CO
‰∫åÊ∞ßÂåñÁ¢≥	CO‚ÇÇ
‰∫îÊ∞ßÂåñ‰∫åÁ£∑	P‚ÇÇO‚ÇÖ
Ê∞ßÂåñÈí†	Na‚ÇÇO
‰∫åÊ∞ßÂåñÊ∞Æ	NO‚ÇÇ
‰∫åÊ∞ßÂåñÁ°Ö	SiO‚ÇÇ
‰∫åÊ∞ßÂåñÁ°´	SO‚ÇÇ
‰∏âÊ∞ßÂåñÁ°´	SO‚ÇÉ
‰∏ÄÊ∞ßÂåñÊ∞Æ	NO
Ê∞ßÂåñÈïÅ	MgO
Ê∞ßÂåñÈìú	CuO
Ê∞ßÂåñÈí°	BaO
Ê∞ßÂåñ‰∫öÈìú	Cu‚ÇÇO
Ê∞ßÂåñ‰∫öÈìÅ	FeO
‰∏âÊ∞ßÂåñ‰∫åÈìÅ	Fe‚ÇÇO‚ÇÉ
ÂõõÊ∞ßÂåñ‰∏âÈìÅ	Fe‚ÇÉO‚ÇÑ
‰∏âÊ∞ßÂåñ‰∫åÈìù	Al‚ÇÇO‚ÇÉ
‰∏âÊ∞ßÂåñÈí®	WO‚ÇÉ
Ê∞ßÂåñÈì∂	Ag‚ÇÇO
Ê∞ßÂåñÈìÖ	PbO
‰∫åÊ∞ßÂåñÈî∞	MnO‚ÇÇ
Ê∞ØÂåñÈíæ	KCl
Ê∞ØÂåñÈí†	NaCl
Ê∞ØÂåñÈïÅ	MgCl‚ÇÇ
Ê∞ØÂåñÈíô	CaCl‚ÇÇ
Ê∞ØÂåñÈìú	CuCl‚ÇÇ
Ê∞ØÂåñÈîå	ZnCl‚ÇÇ
Ê∞ØÂåñÈí°	BaCl‚ÇÇ
Ê∞ØÂåñÈìù	AlCl‚ÇÉ
Ê∞ØÂåñ‰∫öÈìÅ	FeCl‚ÇÇ
Ê∞ØÂåñÈìÅ	FeCl‚ÇÉ
Ê∞ØÂåñÈì∂	AgCl
Á°´ÈÖ∏	H‚ÇÇSO‚ÇÑ
ÁõêÈÖ∏	HCl
Á°ùÈÖ∏	HNO‚ÇÉ
Á¢≥ÈÖ∏	H‚ÇÇCO‚ÇÉ
‰∫öÁ°´ÈÖ∏	H‚ÇÇSO‚ÇÉ
Á°´ÂåñÊ∞¢	H‚ÇÇS
Ê∫¥ÂåñÊ∞¢	HBr
Á°´ÈÖ∏Èí°	BaSO‚ÇÑ
Á°´ÈÖ∏Èíô	CaSO‚ÇÑ
Á°´ÈÖ∏Èíæ	K‚ÇÇSO‚ÇÑ
Á°´ÈÖ∏ÈïÅ	MgSO‚ÇÑ
Á°´ÈÖ∏‰∫öÈìÅ	FeSO‚ÇÑ
Á°´ÈÖ∏ÈìÅ	Fe‚ÇÇ(SO‚ÇÑ)‚ÇÉ
Á°´ÈÖ∏Èìù	Al‚ÇÇ(SO‚ÇÑ)‚ÇÉ
Á°´ÈÖ∏Ê∞¢Èí†	NaHSO‚ÇÑ
Á°´ÈÖ∏Ê∞¢Èíæ	KHSO‚ÇÑ
‰∫öÁ°´ÈÖ∏Èí†	NaSO‚ÇÉ
Á°ùÈÖ∏Èí†	NaNO‚ÇÉ
Á°ùÈÖ∏Èíæ	KNO‚ÇÉ
Á°ùÈÖ∏Èì∂	AgNO‚ÇÉ
Á°ùÈÖ∏ÈïÅ	Mg(NO‚ÇÉ)‚ÇÇ
Á°ùÈÖ∏Èìú	Cu(NO‚ÇÉ)‚ÇÇ
Á°ùÈÖ∏Èíô	Ca(NO‚ÇÉ)‚ÇÇ
Á¢≥ÈÖ∏Èí†	Na‚ÇÇCO‚ÇÉ
Á¢≥ÈÖ∏Èíô	CaCO‚ÇÉ
Á¢≥ÈÖ∏ÈïÅ	MgCO‚ÇÉ
Á¢≥ÈÖ∏Èíæ	K‚ÇÇCO‚ÇÉ
Ê∞¢Ê∞ßÂåñÈí†	NaOH
Ê∞¢Ê∞ßÂåñÈíô	Ca(OH)‚ÇÇ
Ê∞¢Ê∞ßÂåñÈí°	Ba(OH)‚ÇÇ
Ê∞¢Ê∞ßÂåñÈïÅ	Mg(OH)‚ÇÇ
Ê∞¢Ê∞ßÂåñÈìú	Cu(OH)‚ÇÇ
Ê∞¢Ê∞ßÂåñÈíæ	KOH
Ê∞¢Ê∞ßÂåñÈìù	Al(OH)‚ÇÉ
Ê∞¢Ê∞ßÂåñÈìÅ	Fe(OH)‚ÇÉ
Ê∞¢Ê∞ßÂåñ‰∫öÈìÅ	Fe(OH)‚ÇÇ
Áî≤ÁÉ∑	CH‚ÇÑ
‰πôÁÇî	C‚ÇÇH‚ÇÇ
Áî≤ÈÜá	CH‚ÇÉOH
‰πôÈÖ∏	CH‚ÇÉCOOH
Á¢±ÂºèÁ¢≥ÈÖ∏Èìú	Cu‚ÇÇ(OH)‚ÇÇCO‚ÇÉ
Áü≥ËÜè	CaSO‚ÇÑ¬∑2H‚ÇÇO
ÁÜüÁü≥ËÜè	2CaSO‚ÇÑ¬∑H‚ÇÇO
ËìùÁüæ	CuSO‚ÇÑ¬∑‚ÇÖH‚ÇÇO
Á¢≥ÈÖ∏Èí†Êô∂‰Ωì	Na‚ÇÇCO‚ÇÉ¬∑10H‚ÇÇO
Â∞øÁ¥†	CO(NH‚ÇÇ)‚ÇÇ
Á°´ÈÖ∏Èìµ	(NH‚ÇÑ)‚ÇÇSO‚ÇÑ
Á¢≥ÈÖ∏Ê∞¢Èìµ	NH‚ÇÑHCO‚ÇÉ
Á£∑ÈÖ∏‰∫åÊ∞¢Èíæ	KH‚ÇÇPO‚ÇÑ
Ê∞ØÂåñÊ∞¢	HCl
Ê∞¢Ê∞ßÂåñÈìµ	NH‚ÇÑOH
Á£∑ÈÖ∏‰∫åÊ∞¢Èí†	NaH‚ÇÇPO‚ÇÑ
Á°ùÈÖ∏Èîå	Zn(NO‚ÇÉ)‚ÇÇ
ËøáÊ∞ßÂåñÊ∞¢	H‚ÇÇO‚ÇÇ
Ê∞ßÂåñÈíæ	K‚ÇÇO
Ê∞ØÂåñÈìµ	NH‚ÇÑCl
Á°ùÈÖ∏ÈìÖ	Pb(NO‚ÇÉ)‚ÇÇ
Á°´ÂåñÈìú	CuS
Á¢≥ÈÖ∏Ê∞¢Èí†	NaHCO‚ÇÉ
Á°ùÈÖ∏ÈîÇ	LiNO‚ÇÉ
Ê∞¢Ê∞ßÂåñÈîÇ	LiOH
Á£∑ÈÖ∏Èíô	Ca‚ÇÉ(PO‚ÇÑ)‚ÇÇ
ÈòøÂ∞îÊ≥ï	alpha|Œ±|Œë
Ë¥ùÂ°î	beta|Œ≤|Œí
‰ºΩÈ©¨	gamma|Œ≥|Œì
Âæ∑Â∞îÂ°î	delta|Œ¥|Œî
ËâæÊôÆË•øÈöÜ	epsilon|Œµ|Œï
Ê≥ΩÂ°î	zeta|Œ∂|Œñ
‰ºäÂ°î	eta|Œ∑|Œó
Ë•øÂ°î	theta|Œ∏|Œò
Á∫¶Â°î	iota|Œπ|Œô
Âç°Â∏ï	kappa|Œ∫|Œö
ÊãâÂßÜËææ	lambda|Œª|Œõ
ÂÖãË•ø	Œæ|Œû
Â••ÂØÜÂÖãÊàé	omicron|Œø|Œü
Ë•øÊ†ºÈ©¨	sigma|œÉ/œÇ|Œ£
ÂÆáÊôÆË•øÈöÜ	upsilon|œÖ|Œ•
ÊôÆË•ø	psi|œà|Œ®
Â••Á±≥‰ºΩ	omega|œâ|Œ©
Â∏åËÖäÂ≠óÊØç	Œ±Œë|Œ≤Œí|Œ≥Œì|Œ¥Œî|ŒµŒï|Œ∂Œñ|Œ∑Œó|Œ∏Œò|ŒπŒô|Œ∫Œö|ŒªŒõ|ŒºŒú|ŒΩŒù|ŒæŒû|ŒøŒü|œÄŒ†|œÅŒ°|œÉœÇŒ£|œÑŒ§|œÖŒ•|œÜŒ¶|œáŒß|œàŒ®|œâŒ©
Â∏åËÖäÂ≠óÊØçÂ∞èÂÜô	Œ±|Œ≤|Œ≥|Œ¥|Œµ|Œ∂|Œ∑|Œ∏|Œπ|Œ∫|Œª|Œº|ŒΩ|Œæ|Œø|œÄ|œÅ|œÉœÇ|œÑ|œÖ|œÜ|œá|œà|œâ
Â∏åËÖäÂ≠óÊØçÂ§ßÂÜô	Œë|Œí|Œì|Œî|Œï|Œñ|Œó|Œò|Œô|Œö|Œõ|Œú|Œù|Œû|Œü|Œ†|Œ°|Œ£|Œ§|Œ•|Œ¶|Œß|Œ®|Œ©
Â∞èÂÜôÂ∏åËÖäÂ≠óÊØç	Œ±|Œ≤|Œ≥|Œ¥|Œµ|Œ∂|Œ∑|Œ∏|Œπ|Œ∫|Œª|Œº|ŒΩ|Œæ|Œø|œÄ|œÅ|œÉœÇ|œÑ|œÖ|œÜ|œá|œà|œâ
Â§ßÂÜôÂ∏åËÖäÂ≠óÊØç	Œë|Œí|Œì|Œî|Œï|Œñ|Œó|Œò|Œô|Œö|Œõ|Œú|Œù|Œû|Œü|Œ†|Œ°|Œ£|Œ§|Œ•|Œ¶|Œß|Œ®|Œ©
alpha	Œ±|Œë
beta	Œ≤|Œí
gamma	Œ≥|Œì
delta	Œ¥|Œî
epsilon	Œµ|Œï
zeta	Œ∂|Œñ
eta	Œ∑|Œó
theta	Œ∏|Œò
iota	Œπ|Œô
kappa	Œ∫|Œö
lambda	Œª|Œõ
mu	Œº|Œú
nu	ŒΩ|Œù
xi	Œæ|Œû
omicron	Œø|Œü
pi	œÄ|Œ†
rho	œÅ|Œ°
sigma	œÉ|œÇ|Œ£
tau	œÑ|Œ§
upsilon	œÖ|Œ•
phi	œÜ|Œ¶
chi	œá|Œß
psi	œà|Œ®
omega	œâ|Œ©
ÁâõÁöÆ	üêÆüç∫
È≤ÅËøÖ	üë®üèª
Âë®Ê†ë‰∫∫	üë®üèª
È≤ÅËøÖÂñÇÂ•∂	üë®üèª‚Äçüçº
rime	„û¢
‰∏≠Â∑ûÈüµ	Rime
Èº†È°ªÁÆ°	Squirrel
Â∞èÁãºÊØ´	Weasel
‰ªìËæìÂÖ•Ê≥ï	Hamster
Âπ≥Êñπ	¬≤
Âπ≥ÊñπÂéòÁ±≥	cm¬≤
Âπ≥ÊñπÂàÜÁ±≥	dm¬≤
Âπ≥ÊñπÁ±≥	m¬≤
Á´ãÊñπ	¬≥
Á´ãÊñπÂéòÁ±≥	cm¬≥
Á´ãÊñπÂàÜÁ±≥	dm¬≥
Á´ãÊñπÁ±≥	m¬≥
‰∏ÄÊ¨°Êñπ	¬π
‰∫åÊ¨°Êñπ	¬≤
‰∏§Ê¨°Êñπ	¬≤
‰∏âÊ¨°Êñπ	¬≥
ÂõõÊ¨°Êñπ	‚Å¥
‰∫îÊ¨°Êñπ	‚Åµ
ÂÖ≠Ê¨°Êñπ	‚Å∂
‰∏ÉÊ¨°Êñπ	‚Å∑
ÂÖ´Ê¨°Êñπ	‚Å∏
‰πùÊ¨°Êñπ	‚Åπ
ÂçÅÊ¨°Êñπ	¬π‚Å∞
Â∫¶	¬∞
ÊëÑÊ∞èÂ∫¶	‚ÑÉ
ÂçéÊ∞èÂ∫¶	‚Ñâ
ÁÇπ	¬∑|‰∏∂
Èó¥ÈöîÂè∑	¬∑
ËøûÊé•Âè∑	‚Äî
ËøûÊé•Á¨¶	‚Äî
ËøûÂ≠óÁ¨¶	Ôºç
Á†¥ÊäòÂè∑	‚Äî‚Äî
ÂèçÂºïÂè∑	`
apple	Ô£ø
ÂèçÈóÆÂè∑	¬ø
Á∫¶Á≠â‰∫é	‚âà
Á∫¶Á≠â	‚âà
Á∫¶Á≠âÂè∑	‚âà
‰∏çÁ≠â‰∫é	‚â†
‰∏çÁ≠âÂè∑	‚â†
Â§ß‰∫é	>|‚â•
Â§ß‰∫éÂè∑	>|‚â•
Â∞è‰∫é	<|‚â§
Â∞è‰∫éÂè∑	<|‚â§
Â∞è‰∫éÁ≠â‰∫é	‚â§
Â∞è‰∫éÁ≠â‰∫éÂè∑	‚â§
Â§ß‰∫éÁ≠â‰∫é	‚â•
Â§ß‰∫éÁ≠â‰∫éÂè∑	‚â•
Ê†πÂè∑	‚àö
Ê≠£Ë¥üÂè∑	¬±
Ê≠£Ë¥ü	¬±
ÁôæÂàÜÂè∑	%
ÁôæÂàÜ‰πã	%
ÂçÉÂàÜÂè∑	‚Ä∞
ÂçÉÂàÜ‰πã	‚Ä∞
‰∏áÂàÜÂè∑	‚Ä±
‰∏áÂàÜ‰πã	‚Ä±
ÁôæÂàÜÁôæ	100%
ÁôæÂàÜ‰πãÁôæ	100%
ÁôæÂàÜ‰πã‰∏ÄÁôæ	100%
Á∫≥Á≤π	Âçê
Êó†Á©∑Â§ß	‚àû
Êó†Á©∑Â§ßÁ¨¶Âè∑	‚àû
Ê≠£Êó†Á©∑	+‚àû
Ë¥üÊó†Á©∑	-‚àû
ÂúÜÂë®Áéá	œÄ
ËøõÂáªÁöÑÂ∑®‰∫∫	ÈÄ≤ÊíÉ„ÅÆÂ∑®‰∫∫
‰∏≠Â§ÆÁîµËßÜÂè∞	Ë£ÖÂû´ÂÑøÂè∞
Ë£ÖÂû´ÂÑøÂè∞	‰∏≠Â§ÆÁîµËßÜÂè∞
Geralt	Êù∞Ê¥õÁâπ
Êù∞Ê¥õÁâπ	Geralt
ÁÅ≠Èú∏	Thanos
Thanos	ÁÅ≠Èú∏
ÁöÆÂç°‰∏ò	Pikachu
Pikachu	ÁöÆÂç°‰∏ò
Pokemon	Pok√©mon
ÊÅ≠ÂñúÂèëË¥¢	ÊÅ≠ÂñúÁôºË≤°
‰∫∫‰∏ä‰∫∫	‰ªå
‰∫åÁôæ	Áöï
‰∏§Áôæ	Áöï
ÂèåÂñú	Âõç
ÂèåÂñú‰∏¥Èó®	Âõç
Âñú‰∏äÂä†Âñú	Âõç
Ëã±ÂØ∏	Âêã
ÊòüÂ∑¥ÂÖã	Starbucks
ÊØ´Áßí	ms|millisecond
ÂæÆÁßí	Œºs|microsecond
Á∫≥Áßí	ns|nanosecond
ÁöÆÁßí	ps|picosecond
È£ûÁßí	fs|femtosecond
ÈòøÁßí	as|attosecond
ÊØ´Á±≥	mm|millimeter
ÂæÆÁ±≥	Œºm|micrometer
Á∫≥Á±≥	nm|nanometer
ÊéÄÊ°åÂ≠ê	(‚ïØ'-')‚ïØÔ∏µ‚îª‚îÅ‚îª|(‚ïØ¬∞–î¬∞)‚ïØÔ∏µ‚îª‚îÅ‚îª
ÊëÜÊ°åÂ≠ê	‚î¨‚îÄ‚î¨„Éé('-'„Éé)
ËΩ¶È©¨ÁÇÆ	ËªäÈ©¨ÁÇÆ
Âá∫ËΩ¶	Âá∫Ëªä
ÂÆâÂçì	Android
ÈòøÂ∞îÊ≥ïÁ≤íÂ≠ê	Œ±Á≤íÂ≠ê
ÈòøÂ∞îÊ≥ïÂ∞ÑÁ∫ø	Œ±Â∞ÑÁ∫ø
Ë¥ùÂ°îÁ≤íÂ≠ê	Œ≤Á≤íÂ≠ê
Ë¥ùÂ°îÂ∞ÑÁ∫ø	Œ≤Â∞ÑÁ∫ø
‰ºΩÈ©¨ÂàÄ	Œ≥ÂàÄ
‰ºΩÈ©¨Â∞ÑÁ∫ø	Œ≥Â∞ÑÁ∫ø
ÂÖ≠Â≠óÁúüË®Ä	ÂîµÂòõÂë¢Âè≠Âí™ÂêΩ|Áà±Áé©Áé©‰∏çÁé©Êªö
ÂÖ≠Â≠óÂ§ßÊòéÂíí	ÂîµÂòõÂë¢Âè≠Âí™ÂêΩ
Á´ñ	‰∏®
Êíá	‰∏ø
Á´ñÂºØÈí©	‰πö
Á´ñÂºØÈí©ÂÑø	‰πö
Ê®™Êäò	†Éç
Ê®™ÊäòÈí©	†Éå
Ê®™ÊäòÈí©ÂÑø	†Éå
‰∫åÂàÜ‰πã‰∏Ä	¬Ω
‰∏âÂàÜ‰πã‰∏Ä	‚Öì
‰∏âÂàÜ‰πã‰∫å	‚Öî
ÂõõÂàÜ‰πã‰∏Ä	¬º
ÂõõÂàÜ‰πã‰∏â	¬æ
‰∫îÂàÜ‰πã‰∏Ä	‚Öï
‰∫îÂàÜ‰πã‰∫å	‚Öñ
‰∫îÂàÜ‰πã‰∏â	‚Öó
‰∫îÂàÜ‰πãÂõõ	‚Öò
ÂÖ≠ÂàÜ‰πã‰∏Ä	‚Öô
ÂÖ≠ÂàÜ‰πã‰∫î	‚Öö
‰∏ÉÂàÜ‰πã‰∏Ä	‚Öê
ÂÖ´ÂàÜ‰πã‰∏Ä	‚Öõ
ÂÖ´ÂàÜ‰πã‰∏â	‚Öú
ÂÖ´ÂàÜ‰πã‰∫î	‚Öù
ÂÖ´ÂàÜ‰πã‰∏É	‚Öû
‰πùÂàÜ‰πã‰∏Ä	‚Öë
ÂçÅÂàÜ‰πã‰∏Ä	‚Öí
Twitter	ùïè
Êé®Áâπ	ùïè
ÂèàÂèàÂèàÂèà	ÂèàÂèåÂèíÂèï
Ê©°ËÉ∂ÊûúÂÆû	ÂπªÂÖΩÁßç¬∑‰∫∫‰∫∫ÊûúÂÆû¬∑Â∞ºÂç°ÔºàÂ§™Èò≥Á•ûÔºâÂΩ¢ÊÄÅ
Áõ¥ËßíÂºïÂè∑	„Äå„Äç|„Äé„Äè
‰∏ÄÊØî‰∏ÄÊØî‰∏Ä	1:1:1